a : a 
aa : aa 
aaa : aaa 
aaaablm : alabama 
aaaacdgmrs : madagascar 
aaabbrr : barbara 
aaabcehillpt : alphabetical 
aaabdesst : databases 
aaabdest : database 
aaabdmorss : ambassador 
aaabeijnrz : azerbaijan 
aaabeillnuv : unavailable 
aaabeillv : available 
aaabhmr : abraham 
aaabhms : bahamas 
aaabiiilltvy : availability 
aaabiln : albania 
aaabir : arabia 
aaabnn : banana 
aaaccdilorrsuv : cardiovascular 
aaaccehiinorrttz : characterization 
aaaccehilmprstu : pharmaceuticals 
aaaccehilmprtu : pharmaceutical 
aaaccinrtt : antarctica 
aaacdillmrty : dramatically 
aaacdinn : canadian 
aaacdn : canada 
aaaceenppr : appearance 
aaacehilmmtt : mathematical 
aaacehknsstw : saskatchewan 
aaacginru : nicaragua 
aaacijm : jamaica 
aaacillmottuy : automatically 
aaacillnty : analytical 
aaadegnstv : advantages 
aaadegntv : advantage 
aaadeilnrx : alexandria 
aaademtt : metadata 
aaadinoptt : adaptation 
aaadmn : amanda 
aaaeglmtu : guatemala 
aaaeilmnprrty : parliamentary 
aaafghinnst : afghanistan 
aaaghpprr : paragraph 
aaaghpprrs : paragraphs 
aaagiilnnoortz : organizational 
aaaginr : niagara 
aaagpruy : paraguay 
aaahiimnnrtu : humanitarian 
aaahiinw : hawaiian 
aaahkknstz : kazakhstan 
aaahmnntt : manhattan 
aaahmy : yamaha 
aaahnnsv : savannah 
aaaijmnru : marijuana 
aaailmsy : malaysia 
aaailnrstu : australian 
aaailpprs : appraisal 
aaailrstu : australia 
aaainntz : tanzania 
aaakls : alaska 
aaaknrss : arkansas 
aaalntt : atlanta 
aaamnp : panama 
aaapprstu : apparatus 
aaartv : avatar 
aabbceinr : caribbean 
aabbddnor : broadband 
aabbdors : barbados 
aabbekllst : basketball 
aabbells : baseball 
aabcceelpt : acceptable 
aabcciilnottuy : accountability 
aabccjkkl : blackjack 
aabcckkrst : trackbacks 
aabcckkrt : trackback 
aabcdeln : balanced 
aabcdginorst : broadcasting 
aabcdimo : cambodia 
aabcdorst : broadcast 
aabcehilrt : charitable 
aabceiiilpst : capabilities 
aabceilloortv : collaborative 
aabceillpp : applicable 
aabceilrt : bacterial 
aabceirt : bacteria 
aabcekppr : paperback 
aabcekpprs : paperbacks 
aabcelmopr : comparable 
aabceln : balance 
aabcelnor : barcelona 
aabcelp : capable 
aabcenrr : canberra 
aabciilnort : calibration 
aabciilpty : capability 
aabciinnrt : britannica 
aabcillnooort : collaboration 
aabcillsy : basically 
aabcir : arabic 
aabcklpy : playback 
aabcloruvy : vocabulary 
aabcort : acrobat 
aabcrsstt : abstracts 
aabcrstt : abstract 
aabddellnoow : downloadable 
aabddenno : abandoned 
aabddgh : baghdad 
aabdefflor : affordable 
aabdeghlns : bangladesh 
aabdejlstu : adjustable 
aabdghns : handbags 
aabdlm : lambda 
aabdor : abroad 
aabdorwy : broadway 
aabeeklmrr : remarkable 
aabeelnors : reasonable 
aabeemns : basename 
aabefkrst : breakfast 
aabeggr : garbage 
aabeglr : algebra 
aabehiiilnortt : rehabilitation 
aabehilorv : behavioral 
aabeiilmmor : memorabilia 
aabeiilstty : beastiality 
aabeilnsstu : sustainable 
aabeiloorrst : laboratories 
aabeilrsv : variables 
aabeilrv : variable 
aabeilstty : beastality 
aabeknrs : nebraska 
aabelluv : valuable 
aabelnorsy : reasonably 
aabelpy : payable 
aabelrt : alberta 
aabgggnn : gangbang 
aabgiilnor : aboriginal 
aabgilnru : bulgarian 
aabgilrrt : gibraltar 
aabgilru : bulgaria 
aabgimnrsttu : masturbating 
aabginr : bargain 
aabginrs : bargains 
aabhinr : bahrain 
aabhitt : habitat 
aabiiilnssttuy : sustainability 
aabiilnrr : librarian 
aabiilnrz : brazilian 
aabiimn : namibia 
aabiinorrtt : arbitration 
aabillnpt : paintball 
aabillnssttuy : substantially 
aabilnssttu : substantial 
aabimnorsttu : masturbation 
aabimnot : manitoba 
aabimz : zambia 
aabirrrty : arbitrary 
aablny : albany 
aabloorrty : laboratory 
aabmnt : batman 
aabms : samba 
aabnostw : botswana 
aabr : arab 
aabru : aruba 
aacccdenor : accordance 
aaccceenpt : acceptance 
aacccehiirrsstt : characteristics 
aacccehiirrstt : characteristic 
aacccruy : accuracy 
aaccdeehirrtz : characterized 
aaccdeiinortt : accreditation 
aaccdeim : academic 
aaccdeimnop : accompanied 
aaccdeims : academics 
aaccdelltu : calculated 
aaccdemmoot : accommodate 
aaccdill : cadillac 
aaccdimmnooost : accommodations 
aaccdimmnooot : accommodation 
aaccdir : cardiac 
aaccdovy : advocacy 
aacceelnr : clearance 
aaccehilmn : mechanical 
aaccehilrrttu : architectural 
aaccehrrst : characters 
aaccehrrt : character 
aacceillnnot : cancellation 
aacceilmprt : malpractice 
aacceinsv : vacancies 
aaccelltu : calculate 
aaccelprstu : spectacular 
aaccelrtuy : accurately 
aaccertu : accurate 
aaccfiiilnosst : classification 
aaccgimnnopy : accompanying 
aaccillnoosy : occasionally 
aaccillnostu : calculations 
aaccillnotu : calculation 
aaccillss : classical 
aaccilnooptu : occupational 
aaccilnoos : occasional 
aaccilprt : practical 
aaccipty : capacity 
aaccllorstu : calculators 
aaccllortu : calculator 
aacddeinst : candidates 
aacddeint : candidate 
aacddenv : advanced 
aacdeeipprt : appreciated 
aacdeemnntv : advancement 
aacdeenntt : attendance 
aacdefmnrtuu : manufactured 
aacdehlrt : cathedral 
aacdehtt : attached 
aacdeiinptt : anticipated 
aacdeiipprtt : participated 
aacdeilnort : declaration 
aacdeilnotu : educational 
aacdeimmor : macromedia 
aacdeimno : macedonia 
aacdeiosst : associated 
aacdeittv : activated 
aacdejnt : adjacent 
aacdektt : attacked 
aacdellot : allocated 
aacdelnps : landscape 
aacdelnpss : landscapes 
aacdelnr : calendar 
aacdelnrs : calendars 
aacdemrrst : mastercard 
aacdemy : academy 
aacdensv : advances 
aacdenv : advance 
aacdeotv : advocate 
aacder : arcade 
aacdilr : radical 
aacdimrt : dramatic 
aacdklnu : auckland 
aacdkpr : packard 
aaceehhlrt : healthcare 
aaceeilnorrt : recreational 
aaceeimnnnt : maintenance 
aaceeinnrss : renaissance 
aaceeipprt : appreciate 
aaceeirrstt : secretariat 
aaceeklmprt : marketplace 
aaceemnps : namespace 
aaceeoprs : aerospace 
aacefgnrr : fragrance 
aacefgnrrs : fragrances 
aacefiiltt : facilitate 
aacefmnrrstuu : manufacturers 
aacefmnrrtuu : manufacturer 
aacefmnrtuu : manufacture 
aacegghilopr : geographical 
aaceghmnp : champagne 
aacegkp : package 
aacegkps : packages 
aaceglotu : catalogue 
aacehiinnotttu : authentication 
aacehimmstt : mathematics 
aacehimprs : pharmacies 
aacehmnrrsstt : starsmerchant 
aacehmnsttt : attachments 
aacehmnttt : attachment 
aacehmssssttu : massachusetts 
aacehopprs : approaches 
aacehp : apache 
aaceiilnrrt : interracial 
aaceiinopprt : appreciation 
aaceiipprtt : participate 
aaceijlnotu : ejaculation 
aaceillmt : metallica 
aaceilln : alliance 
aaceilnpp : appliance 
aaceilnpps : appliances 
aaceimnr : american 
aaceimnrs : americans 
aaceimoprtv : comparative 
aaceimr : america 
aaceimrs : americas 
aaceinrv : variance 
aaceinssst : assistance 
aaceiossst : associates 
aaceiosst : associate 
aaceirtttv : attractive 
aacellnow : allowance 
aacellw : wallace 
aacelnrst : lancaster 
aacelp : palace 
aacemnorst : sacramento 
aacemr : camera 
aacemrs : cameras 
aacennprrsty : transparency 
aacenrssu : assurance 
aacfgiinnst : fascinating 
aacfgimnnrtuu : manufacturing 
aacfiiilnoqstu : qualifications 
aacfiiilnoqtu : qualification 
aacfiiilrt : artificial 
aacfiilnn : financial 
aacfiilnor : california 
aacfiinosstt : satisfaction 
aacfil : facial 
aacfinr : african 
aacfinstt : fantastic 
aacfiorsstty : satisfactory 
aacfir : africa 
aacfirrt : aircraft 
aacfrrtw : warcraft 
aacggiknp : packaging 
aacghilpr : graphical 
aacghlmoopry : pharmacology 
aacgiiinpprtt : participating 
aacgillrrtuu : agricultural 
aacgilm : magical 
aacgilnnoorsttu : congratulations 
aacgimnp : campaign 
aacgimnps : campaigns 
aacgir : garcia 
aacglost : catalogs 
aacglot : catalog 
aacglry : calgary 
aachimnr : chairman 
aachmpry : pharmacy 
aachoppr : approach 
aachtt : attach 
aaciiinopprtt : participation 
aaciilnoppst : applications 
aaciilnoppt : application 
aaciilssttt : statistical 
aaciimnnnoott : contamination 
aaciinoossst : associations 
aaciinoosst : association 
aaciinottv : activation 
aaciinpprstt : participants 
aaciinpprtt : participant 
aaciiprt : patricia 
aacijprstv : javascript 
aacillnoot : allocation 
aacillprrtuy : particularly 
aacilmnoopttu : computational 
aacilnootv : vocational 
aacilnor : carolina 
aacilnppst : applicants 
aacilnppt : applicant 
aacilnrv : carnival 
aacilntt : atlantic 
aacilprrtu : particular 
aacilpt : capital 
aacilr : racial 
aacimottu : automatic 
aacinnops : panasonic 
aacinnorsstt : transactions 
aacinnorstt : transaction 
aacinorsttt : attractions 
aacinorttt : attraction 
aacinostv : vacations 
aacinotv : vacation 
aacinpt : captain 
aacintv : vatican 
aaciort : croatia 
aaciqtu : aquatic 
aacis : isaac 
aackstt : attacks 
aacktt : attack 
aaclltuy : actually 
aacln : canal 
aaclost : coastal 
aaclr : clara 
aaclstty : catalyst 
aaclsu : casual 
aacltu : actual 
aacmny : cayman 
aacn : ncaa 
aacnrs : nascar 
aacnsv : canvas 
aacrttt : attract 
aacs : casa 
aad : ada 
aaddeegnrrtuu : undergraduate 
aaddeeil : adelaide 
aaddeellru : lauderdale 
aaddegm : damaged 
aaddegrtu : graduated 
aaddehmn : handmade 
aaddept : adapted 
aadderw : awarded 
aaddiillnoty : additionally 
aaddiilnot : additional 
aaddis : adidas 
aaddms : saddam 
aaddnrsst : standards 
aaddnrst : standard 
aadeeeimnnrrt : mediterranean 
aadeegnrtu : guaranteed 
aadeehqrrstu : headquarters 
aadeelmnprtt : departmental 
aadeelnrx : alexander 
aadeelrw : delaware 
aadeeltuv : evaluated 
aadeeppr : appeared 
aadeeprst : separated 
aadeeqtu : adequate 
aadeffiilt : affiliated 
aadeflmnnstu : fundamentals 
aadeflmnntu : fundamental 
aadefrrstw : afterwards 
aadeginr : drainage 
aadegm : damage 
aadegmn : managed 
aadegms : damages 
aadegn : agenda 
aadegnr : grenada 
aadegnrr : arranged 
aadegrstu : graduates 
aadegrtu : graduate 
aadeh : ahead 
aadehhiillpp : philadelphia 
aadehrrw : hardware 
aadeiiimnrsttv : administrative 
aadeiimnnt : maintained 
aadeimnt : animated 
aadeinorrrtxy : extraordinary 
aadeiprs : paradise 
aadeiptv : adaptive 
aadekmrrst : trademarks 
aadekmrrt : trademark 
aadeln : andale 
aadelnrstt : translated 
aadelnyz : analyzed 
aadelnz : zealand 
aadelry : already 
aademmrst : amsterdam 
aademnt : mandate 
aademottu : automated 
aadennott : annotated 
aadenr : andrea 
aadenrs : andreas 
aadenv : nevada 
aadepr : parade 
aadeprst : adapters 
aadeprt : adapter 
aaderw : adware 
aadfir : afraid 
aadgimr : diagram 
aadginortu : graduation 
aadginru : guardian 
aadgllruy : gradually 
aadgnu : uganda 
aadhilnt : thailand 
aadhilrtww : withdrawal 
aadhorsuz : hazardous 
aadhrrv : harvard 
aadhrsz : hazards 
aadhrz : hazard 
aadiiilnnops : indianapolis 
aadiiimnnorstt : administration 
aadiilnortt : traditional 
aadiilnotv : validation 
aadiimnorrsstt : administrators 
aadiimnorrstt : administrator 
aadiinn : indiana 
aadiinort : radiation 
aadilmnn : mainland 
aadilnswz : swaziland 
aadilorr : railroad 
aadin : diana 
aadinr : adrian 
aadklno : oakland 
aadkot : dakota 
aadlls : dallas 
aadlmnp : ampland 
aadlmnry : maryland 
aadlmort : tramadol 
aadlorsv : salvador 
aadls : salad 
aadm : adam 
aadmnno : madonna 
aadmnorty : mandatory 
aadmr : drama 
aadms : adams 
aadmz : mazda 
aadn : dana 
aadnorr : andorra 
aadnqs : nasdaq 
aadnrs : sandra 
aadnrw : rwanda 
aadoprt : adaptor 
aadpyy : payday 
aadrr : radar 
aadrstuy : saturday 
aadrsw : awards 
aadrw : award 
aadt : data 
aaeeehkprss : shakespeare 
aaeefltty : lafayette 
aaeegggrt : aggregate 
aaeeginrtv : vegetarian 
aaeegmmnnt : management 
aaeegmnnrrst : arrangements 
aaeegmnnrrt : arrangement 
aaeegnrstu : guarantees 
aaeegnrtu : guarantee 
aaeegrv : average 
aaeehkqrtu : earthquake 
aaeehrrsw : shareware 
aaeeillnrttvy : alternatively 
aaeeilnrsttv : alternatives 
aaeeilnrttv : alternative 
aaeejnps : japanese 
aaeelnrsstux : transexuales 
aaeelnrtt : alternate 
aaeelprsty : separately 
aaeeltuv : evaluate 
aaeemprrst : parameters 
aaeemprrt : parameter 
aaeenrssw : awareness 
aaeeprst : separate 
aaeffiilst : affiliates 
aaeffiilt : affiliate 
aaefirr : airfare 
aaegglnsu : languages 
aaegglnu : language 
aaeggr : garage 
aaegilntuv : evaluating 
aaegilr : algeria 
aaegimnsz : magazines 
aaegimnz : magazine 
aaegimrr : marriage 
aaeginnrt : argentina 
aaeginppr : appearing 
aaegintv : navigate 
aaegln : angela 
aaegmn : manage 
aaegmnr : manager 
aaegmnrs : managers 
aaegmrrt : margaret 
aaegmss : massage 
aaegnrr : arrange 
aaegpss : passage 
aaegsv : savage 
aaegtwy : gateway 
aaehimn : anaheim 
aaehmnrsst : harassment 
aaeiillnnnortty : internationally 
aaeiilnnnortt : international 
aaeiilnnpst : palestinian 
aaeiimnnostx : examinations 
aaeiimnnotx : examination 
aaeiinoppprrt : inappropriate 
aaeiinqtttuv : quantitative 
aaeilmnprt : parliament 
aaeilmopprtxy : approximately 
aaeilmrst : materials 
aaeilmrt : material 
aaeilnnnpsvy : pennsylvania 
aaeilnnoptx : explanation 
aaeilnooprt : operational 
aaeilnortx : relaxation 
aaeilnostuv : evaluations 
aaeilnotuv : evaluation 
aaeilnpr : airplane 
aaeilr : aerial 
aaeilrss : salaries 
aaeimmnrst : mainstream 
aaeimnr : armenia 
aaeimopprtx : approximate 
aaeinnrrsvy : anniversary 
aaeinopprrt : preparation 
aaeinoprst : separation 
aaeinrrstw : warranties 
aaeinrrtv : narrative 
aaeioppprrt : appropriate 
aaekkor : karaoke 
aaelllpr : parallel 
aaellpprsw : wallpapers 
aaellpprw : wallpaper 
aaelmp : pamela 
aaelnoss : seasonal 
aaelnpprty : apparently 
aaelnprt : parental 
aaelnpst : pleasant 
aaelnrsstux : transsexual 
aaelnrstt : translate 
aaelnrstux : transexual 
aaelnssy : analyses 
aaelnyz : analyze 
aaelpp : appeal 
aaelppr : apparel 
aaelpps : appeals 
aaemnprstt : apartments 
aaemnprtt : apartment 
aaemrtu : amateur 
aaennnt : antenna 
aaennprrstt : transparent 
aaenpprt : apparent 
aaenr : arena 
aaenrrssttu : restaurants 
aaenrrsttu : restaurant 
aaeppr : appear 
aaepprs : appears 
aaer : area 
aaers : areas 
aaerw : aware 
aaffiiilnot : affiliation 
aaffir : affair 
aaffirs : affairs 
aafhilx : halifax 
aafiilmnnoort : informational 
aafiilmr : familiar 
aafimnnoorrstt : transformation 
aafirs : safari 
aaflt : fatal 
aafnsty : fantasy 
aaggimnn : managing 
aaghhins : shanghai 
aaghinnru : hungarian 
aaghmr : graham 
aaghn : ghana 
aagiiimnnnt : maintaining 
aagiiimnnot : imagination 
aagiinnoorsst : organisations 
aagiinnoorst : organisation 
aagiinnoorstz : organizations 
aagiinnoortz : organization 
aagiinnotv : navigation 
aagilosuvy : yugoslavia 
aagimnz : amazing 
aagin : again 
aaginortv : navigator 
aaginst : against 
aagintu : antigua 
aaginv : vagina 
aagirv : viagra 
aagjru : jaguar 
aaglno : analog angola 
aaglxy : galaxy 
aagmm : gamma 
aagmmrr : grammar 
aagmn : manga 
aagnuy : guyana 
aahiilntu : lithuania 
aahiinoorttuz : authorization 
aahiiw : hawaii 
aahikrs : shakira 
aahimr : mariah 
aahjnnot : jonathan 
aahklmoo : oklahoma 
aahll : allah 
aahllmrs : marshall 
aahlp : alpha 
aahmnort : marathon 
aahmo : omaha 
aahmrt : martha 
aahmst : asthma 
aahnnt : nathan 
aahrs : sarah 
aaiillnnosstt : installations 
aaiillnnostt : installation 
aaiilnosu : louisiana 
aaiilnot : italiano 
aaiilnt : italian 
aaiilt : italia 
aaiimnnot : animation 
aaiimnnst : maintains 
aaiimnnt : maintain 
aaiinooppprrst : appropriations 
aaiinorstv : variations 
aaiinortv : variation 
aaiinotv : aviation 
aaiklosv : slovakia 
aaiknpst : pakistan 
aaiknrt : katrina 
aaillnnoty : nationally 
aaillnv : vanilla 
aaillprty : partially 
aailmmn : mailman 
aailmn : animal 
aailmns : animals 
aailmos : somalia 
aailmrt : martial 
aailmw : malawi 
aailnnorsstt : translations 
aailnnorstt : translation 
aailnnot : national 
aailnopstty : playstation 
aailnort : rational 
aailnostv : salvation 
aailnotuv : valuation 
aailnssy : analysis 
aailnst : latinas 
aailnt : latina 
aailprt : partial 
aailpst : spatial 
aailrrsv : arrivals 
aailrrv : arrival 
aailrwy : railway 
aails : alias 
aailtv : latvia 
aaimnoottu : automation 
aaimnor : romania 
aaimnr : marina 
aaimqruu : aquarium 
aaimr : maria 
aainnnoott : annotation 
aainnooprrsttt : transportation 
aainnrv : nirvana 
aainorz : arizona 
aainottx : taxation 
aains : asian 
aainssstt : assistant 
aaintw : taiwan 
aairstu : austria 
aais : asia 
aajnp : japan 
aajnruy : january 
aajv : java 
aak : aka 
aakln : lanka 
aakmr : karma 
aaknss : kansas 
aal : ala 
aallmnuy : manually 
aalln : allan 
aallnnuy : annually 
aallnrtuy : naturally 
aalmnsu : manuals 
aalmnu : manual 
aalmps : plasma 
aalmr : alarm 
aalmt : malta 
aaln : anal alan 
aalnnu : annual 
aalnorrstt : translator 
aalnrstu : naturals 
aalnrtu : natural 
aalnssty : analysts 
aalnsty : analyst 
aalnv : naval 
aalopprv : approval 
aalppy : paypal 
aalpz : plaza 
aalrsy : salary 
aalru : laura 
aalsstu : assault 
aalst : atlas 
aalswy : always 
aammnry : myanmar 
aamnnot : montana 
aamnoty : anatomy 
aamnoz : amazon 
aamos : samoa 
aampt : tampa 
aamrtu : trauma 
aan : ana 
aann : anna 
aannw : wanna 
aanor : aaron 
aanrrtw : warrant 
aanrrtwy : warranty 
aans : nasa 
aanst : santa 
aanwyy : anyway 
aanxx : xanax 
aaorru : aurora 
aaottw : ottawa 
aappu : papua 
aapr : para 
aaprt : apart 
aapst : pasta 
aaqrt : qatar 
aaqu : aqua 
aarry : array 
aars : sara 
aat : ata 
aawy : away 
ab : ab ba 
abbceklrry : blackberry 
abbcghiiilopr : bibliographic 
abbciill : biblical 
abbe : babe 
abbeimwz : zimbabwe 
abbeinrs : brisbane 
abbeir : barbie 
abbeis : babies 
abbes : babes 
abbghiilopry : bibliography 
abbgnsu : bangbus 
abbiiloprty : probability 
abbirt : rabbit 
abblopry : probably 
abbnrsuu : suburban 
abby : baby 
abc : abc cab 
abcceeilss : accessible 
abcceelllost : collectables 
abcceer : rebecca 
abcceiiilssty : accessibility 
abccoot : tobacco 
abcdeefk : feedback 
abcdeeilnors : considerable 
abcdegimr : cambridge 
abcdeintty : acdbentity 
abcdek : backed 
abcdgknorsu : backgrounds 
abcdgknoru : background 
abceeelrt : celebrate 
abceefiiln : beneficial 
abceegmu : gamecube 
abceehs : beaches 
abceeilnort : celebration 
abceelrst : bracelets 
abceelrt : bracelet 
abceem : became 
abceens : absence 
abceesu : because 
abceflmoort : comfortable 
abceh : beach 
abcehkmnr : benchmark 
abcehlor : bachelor 
abcehmr : chamber 
abcehmrs : chambers 
abcehnrs : branches 
abcehr : breach 
abceilmopt : compatible 
abceilnprsu : republicans 
abceilnpru : republican 
abceinst : cabinets 
abceint : cabinet 
abcekrt : bracket 
abcel : cable 
abcellmp : campbell 
abcels : cables 
abcemsw : webcams 
abcemw : webcam 
abcenssstu : substances 
abcensstu : substance 
abcestw : webcast 
abcfir : fabric 
abcfirs : fabrics 
abcgiilloo : biological 
abcgikn : backing 
abchnr : branch 
abcht : batch 
abciiilmoptty : compatibility 
abciilnopstu : publications 
abciilnoptu : publication 
abciimnnoost : combinations 
abciimnnoot : combination 
abcilmoo : colombia 
abcilmou : columbia 
abcin : cabin 
abcis : basic 
abciss : basics 
abcjo : jacob 
abck : back 
abckl : black 
abckls : blacks 
abcknprtuy : bankruptcy 
abckpu : backup 
abcmot : combat 
abcno : bacon 
abcnor : carbon 
abcr : carb 
abcsu : scuba 
abcu : cuba 
abd : bad 
abddeils : disabled 
abddforr : bradford 
abddhintw : bandwidth 
abdeeenr : aberdeen 
abdeefilltt : battlefield 
abdeehilsst : established 
abdeeilrs : desirable 
abdeeist : diabetes 
abdeell : labeled 
abdeelmss : assembled 
abdeeln : enabled 
abdeet : debate 
abdeg : badge 
abdegno : bondage 
abdehmoorrt : motherboard 
abdehor : deborah 
abdeiiiilsst : disabilities 
abdeiiirsssu : subsidiaries 
abdeiinost : antibodies 
abdeils : disable 
abdein : debian 
abdeinorsu : boundaries 
abdeinot : obtained 
abdeknorw : breakdown 
abdekorsy : keyboards 
abdekory : keyboard 
abdel : blade 
abdeloruv : boulevard 
abdelru : durable 
abdelry : bradley 
abdels : blades 
abdemru : bermuda 
abdenn : banned 
abdenrr : bernard 
abdeo : adobe 
abdeorr : broader 
abdepstu : budapest 
abder : bread 
abdes : based beads 
abdhirty : birthday 
abdhjno : handjob 
abdhjnos : handjobs 
abdhknoo : handbook 
abdhnsu : husband 
abdiiilsty : disability 
abdiirssuy : subsidiary 
abdilr : bridal 
abdinoty : antibody 
abdiu : dubai 
abdl : bald 
abdly : badly 
abdn : band 
abdnnor : brandon 
abdnoorsw : snowboard 
abdnoruy : boundary 
abdnoyy : anybody 
abdnr : brand 
abdnrs : brands 
abdns : bands 
abdor : board broad 
abdors : boards 
abdr : brad 
abeeeglstv : vegetables 
abeeegltv : vegetable 
abeeegrsv : beverages 
abeeegrv : beverage 
abeeelnrw : renewable 
abeegpw : webpage 
abeehilmnsstt : establishment 
abeehiltz : elizabeth 
abeehnt : beneath 
abeeillr : reliable 
abeeilns : baseline 
abeeirstt : batteries 
abeellnruv : vulnerable 
abeelmorv : removable 
abeeln : enable 
abeelns : enables 
abeelqqruuu : albuquerque 
abeelst : beatles 
abeemmnr : membrane 
abeemnst : basement 
abeemrsstw : webmasters 
abeemrstw : webmaster 
abeerst : rebates 
abeert : rebate 
abeerv : beaver 
abefhl : behalf 
abefilltuuy : beautifully 
abefiltuu : beautiful 
abeflst : belfast 
abefrruy : february 
abeghiilnsst : establishing 
abeghiioprs : biographies 
abeghinrt : breathing 
abegiknr : breaking 
abegilnn : enabling 
abegilr : gabriel 
abeginr : bearing 
abegn : began 
abehilsst : establish 
abehioruv : behaviour 
abehiorv : behavior 
abehlr : herbal 
abehr : rehab 
abehrt : breath 
abeiiiillst : liabilities 
abeiiillrty : reliability 
abeiiilst : abilities 
abeiillnrtuvy : vulnerability 
abeiilr : liberia 
abeiilrrs : libraries 
abeiilstty : bestiality 
abeiiorstu : obituaries 
abeijmnn : benjamin 
abeiknstuz : uzbekistan 
abeill : liable 
abeillr : liberal 
abeilmmost : metabolism 
abeilmoostu : automobiles 
abeilmootu : automobile 
abeilmort : baltimore 
abeilnprt : printable 
abeilns : lesbian 
abeilnss : lesbians 
abeilstu : suitable 
abeily : bailey 
abeimmoquz : mozambique 
abeimn : ambien 
abeimnt : ambient 
abeinoorsstv : observations 
abeinoorstv : observation 
abeirrr : barrier 
abeirrrs : barriers 
abeirrz : bizarre 
abeirs : serbia 
abeirstttu : attributes 
abeirtttu : attribute 
abeirtz : bizrate 
abekkku : bukkake 
abekl : blake 
abeklnt : blanket 
abekr : break baker brake 
abekrs : breaks brakes 
abeksst : baskets 
abekst : basket 
abel : able 
abell : label 
abellllovy : volleyball 
abellostuy : absolutely 
abells : labels 
abellt : ballet 
abelm : blame 
abelmr : marble 
abelmssy : assembly 
abelnno : lebanon 
abelnoo : boolean 
abelnu : unable 
abeloprt : portable 
abelostu : absolute 
abelrr : barrel 
abelrsu : belarus 
abelrt : albert 
abelrv : verbal 
abelry : barely 
abelst : tables stable 
abelstt : tablets 
abelt : table 
abeltt : battle tablet 
abem : beam 
abemr : amber 
abemssy : embassy 
abemy : maybe 
aben : bean 
abennr : banner 
abennrs : banners 
abenrs : barnes 
abenry : nearby 
abens : beans 
abenst : absent 
abeossst : asbestos 
abeov : above 
aber : bear bare 
abers : bears 
abersst : breasts 
aberst : breast 
abertty : battery 
aberuu : bureau 
aberv : brave 
abes : base 
abess : bases 
abest : beast beats 
abesu : abuse 
abet : beta beat 
abetuy : beauty 
abey : ebay 
abfflou : buffalo 
abflloot : football 
abfllost : softball 
abflosuu : fabulous 
abg : bag gba 
abggilmn : gambling 
abghiimmnr : birmingham 
abghiopry : biography 
abghmru : hamburg 
abgiilnoost : obligations 
abgiilnoot : obligation 
abgiinnot : obtaining 
abgikn : baking 
abgiknn : banking 
abginot : boating 
abgkkno : bangkok 
abgllo : global 
abgn : bang 
abgoot : tobago 
abgr : grab 
abgs : bags 
abhillmtuz : thumbzilla 
abhilmnstu : thumbnails 
abhilmntu : thumbnail 
abhiost : toshiba 
abhist : habits 
abhl : blah 
abhmoorst : bathrooms 
abhmoort : bathroom 
abhntu : bhutan 
abhorr : harbor 
abhorru : harbour 
abhst : baths 
abht : bath 
abiiillty : liability 
abiillnrt : brilliant 
abiilov : bolivia 
abiilstty : stability 
abiilty : ability 
abiinrt : britain 
abil : bali 
abilnrtu : tribunal 
abilnstu : istanbul 
abilr : blair 
abilrry : library 
abilrt : tribal 
abilrz : brazil 
abimmu : mumbai 
abinooprst : absorption 
abinoort : abortion 
abinorw : rainbow 
abinos : bosnia 
abinot : obtain 
abinr : brain brian 
abinry : binary 
abins : basin 
abiorrstv : vibrators 
abiorrtv : vibrator 
abipstt : baptist 
abis : bias 
abiss : basis 
abkkmoor : bookmark 
abkkmoors : bookmarks 
abkln : blank 
abkn : bank 
abkns : banks 
abl : lab 
abll : ball 
abllnoo : balloon 
abllot : ballot 
ablls : balls 
ablm : lamb 
ablmsu : albums 
ablmu : album 
abloort : toolbar 
ablopyy : playboy 
ablor : labor 
abloru : labour 
ablrtu : brutal 
abls : labs 
ablst : blast 
abm : mba 
abmmo : mambo 
abn : nba ban 
abnr : barn 
abnrty : bryant 
abnru : urban 
abnruu : auburn 
abnry : bryan 
aborr : arbor 
abost : boats 
abot : boat 
abotu : about 
abr : bar bra 
abrry : barry 
abrs : bars bras 
abrss : brass 
abrsuu : subaru 
abs : abs 
abss : bass 
abst : tabs 
abt : tab bat tba 
abu : abu 
aby : bay 
ac : ca ac 
acc : acc 
accceimnrsstu : circumstances 
accddeeirt : accredited 
accdeeilnopy : encyclopedia 
accdeelln : cancelled 
accdeept : accepted 
accdeess : accessed 
accdeh : cached 
accdehilmops : accomplished 
accdeilmopt : complicated 
accdeimort : democratic 
accdeinst : accidents 
accdeint : accident 
accdemorr : camcorder 
accdemorrs : camcorders 
accdemory : democracy 
accdenott : contacted 
accdesu : accused 
accdgilnory : accordingly 
accdginor : according 
acceeeennsv : evanescence 
acceefiirstt : certificates 
acceefiirtt : certificate 
acceehirrttu : architecture 
acceeiilmmnnoosttu : telecommunications 
acceeillrt : electrical 
acceeiorsss : accessories 
acceekln : necklace 
acceennortt : concentrate 
accefgiiinns : significance 
accefiiinopsst : specifications 
accefiiinopst : specification 
accefiiinortt : certification 
accefiillpsy : specifically 
accefiirs : sacrifice 
acceghillnoot : technological 
accegilloo : ecological 
acceginpt : accepting 
acceginss : accessing 
acceh : cache 
accehiinnt : technician 
accehilm : chemical 
accehilms : chemicals 
accehilnt : technical 
accehimns : mechanics 
accehirstt : architects 
accehirsty : citysearch 
accehirtt : architect 
accehllnor : chancellor 
accehloot : chocolate 
accehn : chance 
accehns : chances 
accehos : coaches 
acceilmmor : commercial 
acceilmnop : compliance 
acceimmnotu : communicate 
acceimr : ceramic 
acceinnnoorstt : concentrations 
acceinnnoortt : concentration 
acceinv : vaccine 
acceiprst : practices 
acceiprt : practice 
acceln : cancel 
accelnoptu : conceptual 
accenr : cancer 
accent : accent 
acceorssy : accessory 
accepst : accepts 
accept : accept 
access : access 
accfiip : pacific 
accfinors : francisco 
accghilloopsy : psychological 
accghino : coaching 
accghio : chicago 
accginnortt : contracting 
accginnott : contacting 
accginnotu : accounting 
acchilmops : accomplish 
acchilot : catholic 
accho : coach 
acchrst : scratch 
accht : catch 
acciiinnnt : cincinnati 
acciilln : clinical 
acciilmnoopst : complications 
acciilnortu : circulation 
acciilrt : critical 
acciimmnnoostu : communications 
acciimmnnootu : communication 
acciklot : cocktail 
accilmu : calcium 
accilrru : circular 
accilru : crucial 
accilry : acrylic 
accilss : classic 
accilsss : classics 
accinoopstu : occupations 
accinooptu : occupation 
accinoos : occasion 
accinooss : occasions 
accinoprsy : conspiracy 
acciostu : acoustic 
accirt : arctic 
accistt : tactics 
acckr : crack 
acclnnostuy : consultancy 
accmopt : compact 
accnoorrstt : contractors 
accnoorrtt : contractor 
accnorstt : contracts 
accnortt : contract 
accnostt : contacts 
accnostu : accounts 
accnott : contact 
accnotu : account 
acd : cad 
acdddeeit : dedicated 
acddee : decade 
acddeeers : decreased 
acddeegklnow : acknowledged 
acddeelr : declared 
acddees : decades 
acddeetu : educated 
acddehipst : dispatched 
acddehlnstu : deutschland 
acddeiim : medicaid 
acddeiint : indicated 
acddeilnoost : consolidated 
acddeinoort : coordinated 
acddiinot : addiction 
acddlmno : mcdonald 
acdeeers : decrease 
acdeefft : affected 
acdeeghlln : challenged 
acdeegklnow : acknowledge 
acdeegnoru : encouraged 
acdeehimnrs : merchandise 
acdeehiv : achieved 
acdeehnn : enhanced 
acdeehr : reached 
acdeehrs : searched 
acdeeiilpsz : specialized 
acdeeimmnnoorst : recommendations 
acdeeimmnnoort : recommendation 
acdeeimr : medicare 
acdeeinrs : increased 
acdeeinu : audience 
acdeeiortv : decorative 
acdeellnv : cleveland 
acdeelnost : adolescent 
acdeelpr : replaced 
acdeelr : cleared declare 
acdeert : created 
acdef : faced 
acdefiiiinnott : identification 
acdefiiilnnotty : confidentiality 
acdefiilnnot : confidential 
acdefiilnrst : findarticles 
acdefiilss : classified 
acdefiilsss : classifieds 
acdeghimopr : demographic 
acdeghirs : discharge 
acdeghn : changed 
acdeghr : charged 
acdeginort : decorating 
acdeginu : guidance 
acdegirrst : cartridges 
acdegirrt : cartridge 
acdehiiopsstt : sophisticated 
acdehirv : archived 
acdehlnu : launched 
acdehmt : matched 
acdehorr : hardcore 
acdehorrv : hardcover 
acdehprsu : purchased 
acdehtw : watched 
acdeiiinorst : dictionaries 
acdeiillopry : periodically 
acdeiilmrs : disclaimer 
acdeiilmrss : disclaimers 
acdeiilnt : identical 
acdeiimnost : medications 
acdeiimnot : medication 
acdeiinnoorsst : considerations 
acdeiinnoorst : consideration 
acdeiinst : indicates 
acdeiint : indicate 
acdeiiprt : pediatric 
acdeilm : medical claimed decimal 
acdeiln : iceland 
acdeilptu : duplicate 
acdeimnnoottu : documentation 
acdeinnor : ordinance 
acdeinnot : contained 
acdeinooprrt : incorporated 
acdeinoorst : coordinates 
acdeinoort : coordinate 
acdeinotu : education 
acdeinsst : distances 
acdeinst : distance 
acdeinsty : syndicate 
acdeiqru : acquired 
acdeirr : carried 
acdeiv : advice 
acdekp : packed 
acdekrt : tracked 
acdell : called 
acdeln : candle 
acdelns : candles 
acdelot : located 
acdelp : placed 
acdelr : cradle 
acdemmnor : commander 
acdemnortuy : documentary 
acdemopr : compared 
acdemorst : democrats 
acdemort : democrat 
acden : dance 
acdennnou : announced 
acdenns : scanned 
acdenorsy : secondary 
acdeorstu : educators 
acdeoru : ecuador 
acdeot : coated 
acdeprtu : captured 
acder : cedar 
acders : sacred scared 
acdesu : caused 
acdffir : cardiff 
acdfiiimnoost : modifications 
acdfiiimnoot : modification 
acdforrw : crawford 
acdgiiinnt : indicating 
acdgiinost : diagnostic 
acdginn : dancing 
acdh : chad 
acdhilruy : hydraulic 
acdhinorrs : richardson 
acdhinsw : sandwich 
acdhipst : dispatch 
acdhirr : richard 
acdhirrs : richards 
acdi : acid 
acdiiiimnnorst : discrimination 
acdiiilnprsy : disciplinary 
acdiiinnot : indication 
acdiijlu : judicial 
acdiilnnooost : consolidation 
acdiilnnoot : conditional 
acdiimnno : dominican 
acdiinnooort : coordination 
acdiinnosty : syndication 
acdiinorst : indicators 
acdiinort : indicator 
acdiinorty : dictionary 
acdimnsy : dynamics 
acdimny : dynamic 
acdinooorrt : coordinator 
acdis : acids 
acdknorstu : soundtrack 
acdlnost : scotland 
acdlooor : colorado 
acdlortw : worldcat 
acdmmno : command 
acdmmnos : commands 
acdn : cdna 
acdnnu : duncan 
acdny : candy 
acdoprsst : postcards 
acdoprst : postcard 
acdopsst : podcasts 
acdopst : podcast 
acdr : card 
acdrs : cards 
ace : ace 
aceeeflnr : freelance 
aceeeghlrrt : telecharger 
aceeegnprt : percentage 
aceeehimnstv : achievements 
aceeehimntv : achievement 
aceeehmnnnst : enhancements 
aceeehmnnnt : enhancement 
aceeehrrrs : researcher 
aceeehrrrss : researchers 
aceeelmnprt : replacement 
aceeelnrv : relevance 
aceeenrrsssv : screensavers 
aceeenrrssv : screensaver 
aceefilpr : fireplace 
aceefinnr : refinance 
aceefinrst : interfaces 
aceefinrt : interface 
aceeflpu : peaceful 
aceefmnoprr : performance 
aceefmnoprrs : performances 
aceeghlln : challenge 
aceeghllns : challenges 
aceeghnsx : exchanges 
aceeghnx : exchange 
aceegins : agencies 
aceegiorst : categories 
aceegirstt : cigarettes 
aceegirtt : cigarette 
aceegllosu : colleagues 
aceegllou : colleague 
aceegnnorv : governance 
aceegnorsu : encourages 
aceegnoru : encourage 
aceegorv : coverage 
aceehilortt : theoretical 
aceehinrt : catherine 
aceehiprttu : therapeutic 
aceehiv : achieve 
aceehls : chelsea 
aceehmnrst : manchester 
aceehnn : enhance 
aceehpr : cheaper 
aceehpst : cheapest 
aceehrrs : research 
aceehrs : reaches 
aceehrss : searches 
aceehrst : teachers 
aceehrt : teacher 
aceehst : teaches 
aceeiilpsst : specialties 
aceeiinrttv : interactive 
aceeilllnttu : intellectual 
aceeillmnossu : miscellaneous 
aceeillnrsuv : surveillance 
aceeillpsy : especially 
aceeilnoptx : exceptional 
aceeilnr : reliance 
aceeilnrssy : necessarily 
aceeinopsttx : expectations 
aceeinorrt : recreation 
aceeinorstvv : conservative 
aceeinrs : increase 
aceeinrss : increases 
aceeinrsst : resistance 
aceeiooprtv : cooperative 
aceeirtv : creative 
aceellort : electoral 
aceelmnpt : placement 
aceelnort : tolerance 
aceelnr : cleaner 
aceelnrs : cleaners 
aceelnrw : lawrence 
aceelnstw : newcastle 
aceelpr : replace 
aceemnnnnostu : announcements 
aceemnnnnotu : announcement 
aceennrssuy : unnecessary 
aceennrt : entrance 
aceenpst : netscape 
aceenrssy : necessary 
aceep : peace 
aceeps : escape 
aceerr : career 
aceerrs : careers 
aceerrstu : creatures 
aceerrsty : secretary 
aceerrt : terrace 
aceerrtu : creature 
aceerst : creates 
aceert : create 
aceesstt : cassette 
acef : face cafe 
aceffgint : affecting 
aceffst : affects 
acefft : affect 
acefgiimnnt : magnificent 
acefhinrs : franchise 
acefiiilst : facilities 
acefiiinortv : verification 
acefinn : finance 
acefinns : finances 
acefinrrrsttuu : infrastructure 
acefllruy : carefully 
aceflru : careful 
acefnr : france 
aceforsst : forecasts 
aceforst : forecast 
acefrssu : surfaces 
acefrsu : surface 
acefs : faces 
aceg : cage 
acegghillnn : challenging 
acegghiopr : geographic 
acegghlno : changelog 
aceggilloo : geological 
acegginnoru : encouraging 
aceghiinv : achieving 
aceghinnn : enhancing 
aceghinr : reaching 
aceghinrs : searching 
aceghint : teaching 
aceghn : change 
aceghns : changes 
aceghr : charge 
aceghrr : charger 
aceghrrs : chargers 
aceghrs : charges 
acegiiilnpsz : specializing 
acegiilnnrsy : increasingly 
acegiinnrs : increasing 
acegilnn : cleaning 
acegilnnoorss : congressional 
acegilnpr : replacing 
acegilnr : clearing 
acegilrrtuu : agriculture 
acegimnt : magnetic 
aceginrt : creating catering 
acegirstt : strategic 
acegln : glance 
acegly : legacy 
acegnnpry : pregnancy 
acegny : agency 
acegorty : category 
acegoru : courage 
acegostt : cottages 
acegott : cottage 
acegr : grace 
aceh : each 
acehhiloptty : hypothetical 
acehhirry : hierarchy 
acehilm : michael 
acehilr : charlie 
acehilstt : athletics 
acehilt : ethical 
acehiltt : athletic 
acehimmns : mechanism 
acehimmnss : mechanisms 
acehimn : machine 
acehimnry : machinery 
acehimns : machines 
acehimoprst : atmospheric 
acehinrru : hurricane 
acehinttu : authentic 
acehirss : cashiers 
acehirsv : archives 
acehirv : archive 
acehkr : hacker 
acehlmmnootw : commonwealth 
acehlnn : channel 
acehlnns : channels 
acehlnorst : charleston 
acehlnsu : launches 
acehlortt : charlotte 
acehlp : chapel 
acehlr : rachel 
acehlrs : charles 
acehmnrst : merchants 
acehmnrt : merchant 
acehms : schema 
acehmst : matches 
acehorrst : orchestra 
acehortu : outreach 
acehossw : showcase 
acehp : cheap 
acehprssu : purchases 
acehprst : chapters 
acehprsu : purchase 
acehprt : chapter 
acehpst : patches 
acehr : reach 
acehrrt : charter 
acehrs : search 
acehs : chase 
acehst : cheats 
acehstw : watches 
aceht : teach cheat 
aceiiinopprtt : precipitation 
aceiiisttv : activities 
aceiilmpr : empirical 
aceiilnoprt : replication 
aceiilpssst : specialists 
aceiilpsst : specialist 
aceiilrst : realistic 
aceiinnorstt : interactions 
aceiinnortt : interaction 
aceiinoprrstt : practitioners 
aceiinoprrtt : practitioner 
aceiirrt : criteria 
aceiirttvy : creativity 
aceijk : jackie 
aceijkllnosv : jacksonville 
aceijss : jessica 
aceikmnn : nickname 
aceil : alice 
aceillmt : metallic 
aceillpsy : specially 
aceilmmnoprty : complimentary 
aceilmnru : numerical 
aceilmr : miracle 
aceilmt : climate 
aceilmtuuv : cumulative 
aceilmv : livecam 
aceilnnnootv : conventional 
aceilnnnott : continental 
aceilnoorrstv : controversial 
aceilnoorrt : correlation 
aceilnoort : relocation 
aceilnopr : porcelain 
aceilnor : caroline 
aceilnrty : certainly 
aceilpr : replica 
aceilprst : particles 
aceilprt : particle 
aceilps : special 
aceilpss : specials 
aceilpsty : specialty 
aceilr : claire 
aceilrst : articles 
aceilrt : article 
aceilrtv : vertical 
aceilrty : literacy 
aceiltvy : actively 
aceimn : cinema 
aceimnnoopst : compensation 
aceimnoprt : importance 
aceimnops : companies 
aceimnx : mexican 
aceimorvw : microwave 
aceimsstty : systematic 
aceinnoorsstv : conversations 
aceinnoorstv : conservation conversation 
aceinnorst : containers 
aceinnort : container 
aceinnrsu : insurance 
aceinnrttuy : uncertainty 
aceinnsst : instances 
aceinnst : instance 
aceinnt : ancient 
aceinoooprt : cooperation 
aceinooprrt : incorporate 
aceinors : scenario 
aceinorss : scenarios 
aceinorst : reactions creations 
aceinort : creation reaction 
aceinorttx : extraction 
aceinrt : certain 
aceinrtt : interact 
aceioppr : propecia 
aceiort : erotica 
aceiqru : acquire 
aceirrr : carrier 
aceirrrs : carriers 
aceirrs : carries 
aceitv : active 
acejkst : jackets 
acejkt : jacket 
acek : cake 
acekloprw : workplace 
aceklr : clarke 
aceklt : tackle 
acekpst : packets 
acekpt : packet 
acekrrt : tracker 
aceks : cakes 
acel : lace 
acelllru : cellular 
acellmoru : molecular 
acello : locale 
acellops : collapse 
acellr : recall 
acellry : clearly 
acelm : camel 
acelmno : coleman 
aceln : clean lance 
acelnpu : cleanup 
acelnrt : central 
acelnru : nuclear 
acelor : oracle 
acelot : locate 
acelp : place 
acelpr : parcel 
acelps : places 
acelr : clear 
acels : scale 
acelss : scales 
acelsss : classes 
acelst : castle 
acelsu : clause 
aceltt : cattle 
aceltxy : exactly 
acem : came 
acemmnorty : commentary 
acemnooprrty : contemporary 
acemnoor : cameroon 
acemnor : romance cameron 
acemnr : carmen 
acemnsty : symantec 
acemopr : compare 
acempsy : myspace 
acemr : cream 
acems : emacs 
acemsx : sexcam 
acen : acne 
acennnosu : announces 
acennnou : announce 
acennrs : scanner 
acennrss : scanners 
aceno : ocean 
acenoruvv : vancouver 
acenrt : trance 
aceooprrt : corporate 
aceorrt : creator 
acep : cape pace 
aceprt : carpet 
aceprtu : capture 
aceps : space 
acepss : spaces 
acepsst : aspects 
acepst : aspect 
acer : care race acer acre 
acerrt : carter 
acers : acres races 
acersst : actress 
acerssuy : syracuse 
acert : trace 
acerttx : extract 
acery : carey 
aces : case 
acess : cases 
acessu : causes 
acesu : cause sauce 
acesy : casey 
acetu : acute 
acetx : exact 
acev : cave 
acffiilloy : officially 
acffiilo : official 
acffiilos : officials 
acffirt : traffic 
acfgiiilnnsty : significantly 
acfgiiinnst : significant 
acfgiinnn : financing 
acfgiinnoorstu : configurations 
acfgiinnoortu : configuration 
acfgin : facing 
acfiiinnoostt : notifications 
acfiiinnoott : notification 
acfiilnnottuy : functionality 
acfiilty : facility 
acfiimnnoort : confirmation 
acfilnnotu : functional 
acfils : fiscal 
acfinort : fraction 
acfinrs : francis 
acflo : focal 
acfltuy : faculty 
acfny : fancy 
acforst : factors 
acfort : factor 
acforty : factory 
acfrst : crafts 
acfrt : craft 
acfst : facts 
acft : fact 
acgghinn : changing 
acgghinr : charging 
acghhioopprt : photographic 
acghiimn : michigan 
acghimnr : charming 
acghimnt : matching 
acghinprsu : purchasing 
acghintw : watching 
acghipr : graphic 
acghiprs : graphics 
acghtu : caught 
acgiinnnot : containing 
acgiknp : packing 
acgiknrt : tracking 
acgilln : calling 
acgillo : logical 
acgilnp : placing 
acgilnru : cingular 
acgilr : garlic 
acgilrsu : surgical 
acgim : magic 
acgimnopr : comparing 
acgimnp : camping 
acginnns : scanning 
acginor : organic 
acginot : coating 
acginr : racing caring 
acginrry : carrying 
acginst : casting 
acginsu : causing 
acgint : acting 
acgir : craig 
acgor : cargo 
achhiimnopps : championship 
achhiimnoppss : championships 
achhiit : hitachi 
achhiloprss : scholarship 
achhiloprsss : scholarships 
achiiinrstty : christianity 
achiilorst : historical 
achiinps : hispanic 
achiinpssy : physicians 
achiinpsy : physician 
achiinrsst : christians 
achiinrst : christian christina 
achiitw : wichita 
achillpsyy : physically 
achilnos : nicholas 
achilpsy : physical 
achimnop : champion 
achimnops : champions 
achimnost : macintosh 
achimrsst : christmas 
achin : china chain 
achins : chains 
achiprstyy : psychiatry 
achir : chair 
achirs : chairs 
achirty : charity 
achisss : chassis 
achk : hack 
achlloo : alcohol 
achlnu : launch 
achloostu : holocaust 
achlors : scholar 
achlorss : scholars 
achmost : stomach 
achmr : march charm 
achmrs : charms 
achmt : match 
achn : chan 
achnor : anchor 
achnr : ranch 
achos : chaos 
achpt : patch 
achr : char arch 
achrs : crash 
achrst : charts 
achrt : chart 
achs : cash 
acht : chat 
achtw : watch 
achty : yacht 
aci : cia 
aciiiilnotvz : civilization 
aciiilmnopst : implications 
aciiilmnptuy : municipality 
aciiilnopst : politicians 
aciiilnv : civilian 
aciiinoqsstu : acquisitions 
aciiinoqstu : acquisition 
aciillopt : political 
aciilmnoopt : compilation 
aciilmnpu : municipal 
aciilmnr : criminal 
aciilms : islamic 
aciilnnoostttu : constitutional 
aciilnnorsttu : instructional 
aciilnoot : coalition 
aciilnoprv : provincial 
aciilnppr : principal 
aciils : cialis 
aciilt : italic 
aciimnssu : musicians 
aciimnsu : musician 
aciinnoprrstt : transcription 
aciinortv : victorian 
aciinostt : citations 
aciinott : citation 
aciiortv : victoria 
aciirstt : artistic 
aciis : ascii 
aciisssttt : statistics 
aciissttv : activists 
aciittvy : activity 
acikprt : patrick 
acillnnotuy : continually 
acillnoo : colonial 
acillptyy : typically 
acilm : claim 
acilmnopst : complaints 
acilmnopt : complaint compliant 
acilms : claims 
acilmsu : musical 
acilnnoosttu : consultation 
acilnoost : locations 
acilnoot : location 
acilnv : calvin 
aciloprt : tropical 
acilopt : optical capitol 
acilos : social 
acilpsst : plastics 
acilpst : plastic 
acilpty : typical 
acilrty : clarity 
acilu : lucia 
acimnnoop : companion 
acimno : monica 
acimnooprs : comparison 
acimnooprss : comparisons 
acimnoopttu : computation 
acimnort : romantic 
acimot : atomic 
acimpst : impacts 
acimpt : impact 
acinnorsstt : constraints 
acinnorstt : constraint 
acinnost : contains 
acinnot : contain 
acinoooprrst : corporations 
acinoooprrt : corporation 
acinopt : pontiac 
acinos : casino 
acinoss : casinos 
acinost : actions 
acinostu : auctions 
acinot : action 
acinotu : auction caution 
acinp : panic apnic 
acinprrsstt : transcripts 
acinprrstt : transcript 
acio : ciao 
acios : casio 
aciost : scotia 
aciprvy : privacy 
acir : rica 
acistt : static 
acjk : jack 
acjknos : jackson 
ackl : lack 
acklr : clark 
ackp : pack 
ackps : packs 
ackr : rack 
ackrs : racks 
ackrst : tracks 
ackrt : track 
ackst : stack 
acl : cal 
acll : call 
acllloy : locally 
acllnorw : cornwall 
acllo : local 
acllor : collar 
acllorr : carroll 
acllrtuu : cultural 
aclls : calls 
aclm : calm 
aclmoorss : classroom 
acln : clan 
aclnnossttu : consultants 
aclnnosttu : consultant 
aclnnostty : constantly 
aclo : coal 
acloort : locator 
aclor : carol coral carlo 
aclors : carlos 
aclosv : vocals 
aclov : vocal 
aclr : carl 
aclrrsttuu : structural 
aclrsty : crystal 
aclss : class 
aclsu : lucas 
acly : clay 
acm : mac cam acm 
acmnoo : monaco 
acmnopy : company 
acmopq : compaq 
acmor : macro marco 
acmp : camp 
acmps : camps 
acmpsu : campus 
acmr : marc 
acmrsu : marcus 
acms : cams 
acmuuv : vacuum 
acn : can 
acnnno : cannon 
acnno : canon 
acnnostt : constant 
acnnoy : canyon 
acnny : nancy 
acnoorst : cartoons 
acnoort : cartoon 
acnorrty : contrary 
acnorstt : contrast 
acns : scan 
acnt : cant 
acoprz : prozac 
acorrtt : tractor 
acors : oscar 
acorss : across 
acorst : actors 
acort : actor 
acost : coast costa 
acot : coat 
acp : cap pac 
acpr : crap 
acprs : craps sparc 
acps : caps 
acr : car arc rca 
acrry : carry 
acrs : cars 
acrsy : scary 
acrt : cart 
acrtt : tract 
acrty : tracy 
acryz : crazy 
acs : cas 
acst : cast acts cats 
act : act cat 
ad : ad da 
add : add dad 
addde : added 
adddeerss : addressed 
adddelnoow : downloaded 
adddy : daddy 
adde : dead 
addeeegnnr : endangered 
addeefnnt : defendant 
addeeginst : designated 
addeegrr : regarded 
addeeh : headed 
addeehr : redhead 
addeehrt : threaded 
addeeiimnrst : administered 
addeeiln : deadline 
addeeilt : detailed 
addeeiprsw : widespread 
addeely : delayed 
addeemn : amended 
addeemnorstt : demonstrated 
addeenpx : expanded 
addeenswy : wednesday 
addeentt : attended 
addeersss : addresses 
addeflnnnouw : newfoundland 
addegimnn : demanding 
addeginnnrstu : understanding 
addeginrss : addressing 
addehhln : handheld 
addehhlns : handhelds 
addehln : handled 
addehn : handed 
addeiinoppst : disappointed 
addeilpsy : displayed 
addeimtt : admitted 
addeisv : advised 
addejstu : adjusted 
addelo : loaded 
addelopu : uploaded 
addelr : ladder 
addely : deadly 
addemn : demand 
addemns : demands 
addennrstu : understand 
addenot : donated 
addeopt : adopted 
addeptu : updated 
adderss : address 
addersw : edwards 
adderw : edward 
addet : dated 
addgilnnoow : downloading 
addgin : adding 
addhoorw : hardwood 
addiiillnuvy : individually 
addiiilnsuv : individuals 
addiiilnuv : individual 
addiinost : additions 
addiinot : addition 
addiinrt : trinidad 
addilmns : midlands 
addimno : diamond 
addimnos : diamonds 
addimr : madrid 
addinosv : davidson 
addiv : david 
addlno : donald 
addlnoosw : downloads 
addlnoow : download 
adds : adds 
adeeegnrt : generated 
adeeehnrtt : threatened 
adeeeiimnrtt : intermediate 
adeeeimnrssttv : advertisements 
adeeeimnrsttv : advertisement 
adeeellmnoptv : developmental 
adeeelrs : released 
adeeelrv : revealed 
adeeeprst : desperate 
adeeeprt : repeated 
adeeffiilnrt : differential 
adeefinort : federation 
adeeflr : federal 
adeefnrrrst : transferred 
adeefrtu : featured 
adeeft : defeat 
adeeggn : engaged 
adeeghrt : gathered 
adeegiinsttv : investigated 
adeegilnot : delegation 
adeeginrtt : integrated 
adeegirs : disagree 
adeegll : alleged 
adeeglnry : legendary 
adeeglrrss : regardless 
adeeglrtu : regulated 
adeegr : agreed 
adeegrtt : targeted 
adeehhlorrss : shareholders 
adeehhnops : headphones 
adeehiln : headline 
adeehilns : headlines 
adeehilprs : leadership 
adeehklorsst : stakeholders 
adeehlnnrst : netherlands 
adeehnpp : happened 
adeehorv : overhead 
adeehr : header 
adeehrs : headers 
adeehrstw : watershed 
adeehst : headset 
adeeht : heated 
adeeiilmmty : immediately 
adeeiilnprst : presidential 
adeeiilnrst : residential 
adeeiimmt : immediate 
adeeiimnnortt : determination 
adeeilmt : dealtime 
adeeilmv : medieval 
adeeilnoprsz : personalized 
adeeilnpx : explained 
adeeilrz : realized 
adeeimnr : remained 
adeeimnrr : remainder 
adeeimnx : examined 
adeeimrt : diameter 
adeeimstt : estimated 
adeeinrt : retained 
adeeipx : expedia 
adeeirrsstv : advertisers 
adeeirrstv : advertiser 
adeeirstv : advertise 
adeeiss : disease 
adeeisss : diseases 
adeeisttw : statewide 
adeeknnrtu : undertaken 
adeeknrtu : undertake 
adeelmr : emerald 
adeelnnqsu : queensland 
adeelnr : learned 
adeelntt : talented 
adeelps : pleased 
adeelr : leader dealer 
adeelrs : leaders dealers 
adeelrt : related altered 
adeels : sealed 
adeemmnnst : amendments 
adeemmnnt : amendment 
adeemnorsstt : demonstrates 
adeemnorstt : demonstrate 
adeemnprstt : departments 
adeemnprtt : department 
adeemort : moderate 
adeempttt : attempted 
adeemrsu : measured 
adeenr : earned 
adeenrruw : underwear 
adeenrstuv : adventures 
adeenrsw : answered 
adeenrtuv : adventure 
adeeoprt : operated 
adeepprr : prepared 
adeeprrtu : departure 
adeerr : reader 
adeerrs : readers 
adeerrst : arrested 
adeerstyy : yesterday 
adeersv : adverse 
adeertt : treated 
adeervyy : everyday 
adeessss : assessed 
adef : deaf 
adeffiilr : fairfield 
adefiilqu : qualified 
adefiisst : satisfied 
adefil : failed 
adefinrr : infrared 
adeflr : alfred 
adefltu : default 
adefmr : framed 
adefoos : seafood 
adeg : aged 
adegginnr : gardening 
adegginrr : regarding 
adeggst : gadgets 
adeggt : tagged 
adeghin : heading 
adeghrstu : daughters 
adeghrtu : daughter 
adegiinnost : designation 
adegiinrstv : advertising 
adegiln : leading dealing 
adegilou : dialogue 
adegimntu : magnitude 
adegin : gained 
adeginnpx : expanding 
adeginntt : attending 
adeginors : organised 
adeginorz : organized 
adeginprs : spreading 
adeginr : reading 
adeginrs : readings 
adeginss : assigned 
adeglnn : england 
adeglr : gerald 
adegnorrtuw : groundwater 
adegnorsu : dangerous 
adegnr : garden danger grande 
adegnrs : gardens 
adegnrt : granted 
adegos : dosage 
adegprsu : upgrades 
adegpru : upgrade 
adegr : grade edgar 
adegrr : regard 
adegrrs : regards 
adegrs : grades 
adegrty : tragedy 
adegru : argued 
adeh : head 
adehinortuuz : unauthorized 
adehiortuz : authorized 
adehlmno : homeland 
adehln : handle 
adehlns : handles 
adehlr : herald 
adehps : shaped 
adehr : heard 
adehrr : harder 
adehrs : shared 
adehrst : threads 
adehrt : thread 
adehs : heads shade 
adehss : shades 
adehst : deaths 
adehsv : shaved 
adeht : death 
adei : idea 
adeiiikmw : mediawiki 
adeiiikpw : wikipedia 
adeiiintt : initiated 
adeiilmmtu : multimedia 
adeiilmnnos : dimensional 
adeiilorst : editorials 
adeiilort : editorial 
adeiimnott : meditation 
adeiimpr : impaired 
adeiinnnos : indonesian 
adeiinnos : indonesia 
adeiinnosstt : destinations 
adeiinnostt : destination 
adeiinnotw : nationwide 
adeiinotv : deviation 
adeil : ideal 
adeill : allied 
adeillnst : installed 
adeillrsttu : illustrated 
adeilm : mailed 
adeilmsv : maldives 
adeiln : daniel denial 
adeilnr : ireland 
adeilnrstwz : switzerland 
adeilost : isolated 
adeilpp : applied 
adeilry : readily 
adeils : ladies 
adeilst : details 
adeilt : detail 
adeilttu : latitude 
adeim : media aimed 
adeimn : median maiden 
adeimnnoorstt : demonstration 
adeimnnot : nominated 
adeimnrsttt : transmitted 
adeimottv : motivated 
adeimrr : married 
adein : diane 
adeinoppt : appointed 
adeinppx : appendix 
adeinpt : painted 
adeinrt : trained 
adeinsstu : sustained 
adeinst : instead 
adeintv : deviant 
adeippr : prepaid 
adeipx : adipex 
adeirrv : arrived 
adeirs : raised 
adeirsst : disaster 
adeirty : dietary 
adeirv : varied 
adeis : ideas aside 
adeissst : assisted 
adeistttu : attitudes 
adeisttu : situated 
adeisv : advise 
adeitttu : attitude 
adej : jade 
adejmnssttu : adjustments 
adejmnsttu : adjustment 
adeklt : talked 
adeklw : walked 
adekmnr : denmark 
adekmr : marked 
adekn : naked 
adeknr : ranked 
adeknrss : darkness 
adeks : asked 
adel : lead deal dale 
adellow : allowed 
adelm : medal 
adeln : laden 
adelnnp : planned 
adelnor : leonard 
adelnt : dental 
adelor : reload 
adelpy : played 
adels : deals leads 
adelsy : delays 
adelt : delta dealt 
adeluv : valued 
adely : delay 
adem : made dame 
ademn : named amend 
ademnss : madness 
ademoorrst : moderators 
ademoorrt : moderator 
ademr : dream armed 
ademrs : dreams 
ademssu : assumed 
aden : dean 
adennors : anderson 
adennpt : pendant 
adenot : donate 
adenpx : expand 
adenrsw : andrews 
adenrw : andrew warned 
adentt : attend 
adentw : wanted 
adeopprv : approved 
adepprw : wrapped 
adeprs : spread 
adepss : passed 
adepstu : updates 
adeptu : update 
ader : read dear dare 
aderrsw : rewards 
aderrt : trader 
aderrw : reward 
aders : reads 
aderssu : assured 
aderst : trades 
aderstt : started 
adert : trade rated 
adertv : advert 
adery : ready 
adest : dates 
adestt : stated 
adestuy : tuesday 
adesty : stayed steady 
adesv : saved 
adet : date 
adev : dave 
adf : fda 
adffor : afford 
adfgiinnrsu : fundraising 
adfginorrw : forwarding 
adfhorrt : hartford 
adfilnn : finland 
adfilnw : findlaw 
adfilor : florida 
adfinnoostu : foundations 
adfinnootu : foundation 
adfiry : friday 
adfnorst : stanford 
adforrw : forward 
adfrt : draft 
adfru : fraud 
adgginpru : upgrading 
adghhiln : highland 
adghilnn : handling 
adgiilnpsy : displaying 
adgiilt : digital 
adgiinoss : diagnosis 
adgiinov : avoiding 
adgilnn : landing 
adgilno : loading 
adgilo : dialog 
adginnosttu : outstanding 
adginnsst : standings 
adginnst : standing 
adginptu : updating 
adginrsw : drawings 
adginrt : trading 
adginrw : drawing 
adgint : dating 
adgl : glad 
adglosu : douglas 
adgnor : dragon 
adgnr : grand 
adgr : drag grad 
adgrsu : guards 
adgru : guard 
adh : had 
adhiknpt : thinkpad 
adhilosy : holidays 
adhiloy : holiday 
adhins : danish 
adhinuy : hyundai 
adhio : idaho 
adhllno : holland 
adhlor : harold 
adhlry : hardly 
adhmru : durham 
adhn : hand 
adhno : honda 
adhnorsu : honduras 
adhnosstu : thousands 
adhnostu : thousand 
adhns : hands 
adhny : handy 
adhorw : howard 
adhossw : shadows 
adhosw : shadow 
adhr : hard 
adhrstuy : thursday 
adhs : dash 
adi : aid 
adiilnrstu : industrial 
adiilnv : invalid 
adiiltvy : validity 
adiimnoss : admission 
adiimnosss : admissions 
adiin : india 
adiinn : indian 
adiinns : indians 
adiinorstt : traditions 
adiinortt : tradition 
adiinv : nvidia 
adiioprrstv : tripadvisor 
adikn : kinda 
adil : dial laid 
adilmop : diploma 
adiln : linda 
adilns : island 
adilnss : islands 
adilnsy : lindsay 
adilopss : disposal 
adilpry : rapidly 
adilpssy : displays 
adilpsy : display 
adilv : valid 
adily : daily 
adimn : admin 
adimnnot : dominant 
adimno : domain 
adimnos : domains madison 
adimr : mardi 
adimstu : stadium 
adimt : admit 
adinnoost : donations 
adinnoot : donation 
adinoopt : adoption 
adinorry : ordinary 
adinortu : duration 
adinr : drain 
adinrw : darwin 
adinstt : distant 
adior : radio 
adiors : radios 
adiorssv : advisors 
adiorsv : advisor 
adiorsvy : advisory 
adiortu : auditor 
adiou : audio 
adiov : avoid 
adip : paid 
adipr : rapid 
adiprs : rapids 
adir : raid 
adirsu : radius 
adirwz : wizard 
adiry : diary dairy 
adis : said aids 
adisu : saudi 
adisv : davis 
adisy : daisy 
aditu : audit 
adiu : audi 
adjnor : jordan 
adjstu : adjust 
adkko : kodak 
adkr : dark 
adllor : dollar 
adllors : dollars 
adlmoov : moldova 
adlmoru : modular 
adln : land 
adlnoor : orlando 
adlnop : poland 
adlnoprt : portland 
adlnor : arnold ronald roland 
adlnruy : laundry 
adlns : lands 
adlny : dylan 
adlo : load 
adlopu : upload 
adlos : loads 
adls : adsl 
adlstu : adults 
adltu : adult 
adlu : dual 
adly : lady 
adm : mad amd dam 
admn : damn 
admnor : random 
admnory : raymond 
admnoy : monday 
adn : and dan dna 
adnno : donna 
adnny : danny 
adnoru : around 
adnoty : dayton 
adnr : rand 
adnrst : strand 
adnrw : drawn 
adnry : randy 
adns : sand dans 
adnsst : stands 
adnst : stand 
adnsu : sudan 
adnsuy : sunday 
adnsy : sandy 
adnw : dawn 
adny : andy 
adoprsssw : passwords 
adoprssw : password 
adopt : adopt 
ador : road 
adors : roads 
adorstw : towards 
adortw : toward 
adoty : today 
adp : pda pad 
adps : pdas pads 
adqsu : squad 
adqu : quad 
adrsw : draws 
adrsy : yards 
adrw : draw ward 
adry : yard 
ads : ads sad das 
adsu : usda 
adsy : days 
adt : dat 
adu : aud 
ady : day 
ae : ea ae 
aeeeeinprrssttv : representatives 
aeeeeinprrsttv : representative 
aeeefhrrtt : thereafter 
aeeefrrw : freeware 
aeeeggmnnt : engagement 
aeeeglmnnrt : enlargement 
aeeegmnrst : agreements 
aeeegmnrt : agreement 
aeeegnrst : generates 
aeeegnrt : generate 
aeeegnt : teenage 
aeeeilmnprtx : experimental 
aeeeimnnnrttt : entertainment 
aeeeimnstv : vietnamese 
aeeeinnoprrsstt : representations 
aeeeinnoprrstt : representation 
aeeelmnrty : elementary 
aeeelnuvz : venezuela 
aeeelrs : release 
aeeelrss : releases 
aeeemmnrsstu : measurements 
aeeemmnrstu : measurement 
aeeemprrsttu : temperatures 
aeeemprrttu : temperature 
aeefgiorrrrt : refrigerator 
aeefilmn : filename 
aeeflm : female 
aeeflms : females 
aeeflrrr : referral 
aeeflrrrs : referrals 
aeeflrw : welfare 
aeefrstu : features 
aeefrtu : feature 
aeegginnrt : generating 
aeeggirssv : aggressive 
aeegglnoy : genealogy 
aeeggn : engage 
aeeggr : reggae 
aeeghinnrtt : threatening 
aeeghirt : heritage 
aeeghmop : homepage 
aeegiillstv : legislative 
aeegiilmtt : legitimate 
aeegiinnnrtt : entertaining 
aeegiinsttv : investigate 
aeegillrs : galleries 
aeegillrstu : legislature 
aeegilm : mileage 
aeeginnorst : generations 
aeeginnort : generation 
aeeginottv : vegetation 
aeeginrtt : integrate 
aeegintv : negative 
aeegirsstt : strategies 
aeegl : eagle 
aeegllnry : generally 
aeeglmnnortv : governmental 
aeeglmnnt : gentleman 
aeeglnr : general enlarge 
aeeglns : angeles senegal 
aeeglnt : elegant 
aeegls : eagles 
aeeglu : league 
aeegmss : message 
aeegmsss : messages 
aeegnorrst : generators 
aeegnorrt : generator 
aeegnprss : passenger 
aeegnprsss : passengers 
aeegnv : geneva 
aeegr : agree 
aeegrrt : greater 
aeegrs : agrees 
aeegrstt : greatest 
aeegttz : gazette 
aeehhrt : heather 
aeehilmnw : meanwhile 
aeehilpprr : peripheral 
aeehilpprrs : peripherals 
aeehinpst : stephanie 
aeehllnow : halloween 
aeehllosw : wholesale 
aeehlms : shemale 
aeehlmss : shemales 
aeehln : helena 
aeehlnpt : elephant 
aeehlrt : leather 
aeehlstt : athletes 
aeehmoprst : atmosphere 
aeehnrwy : anywhere 
aeehnv : heaven 
aeehorssuw : housewares 
aeehorsuw : warehouse 
aeehrstt : theaters 
aeehrsw : whereas 
aeehrt : heater 
aeehrtt : theatre theater 
aeehrtvw : whatever 
aeehrtw : weather 
aeeiilmmnnoptt : implementation 
aeeiilmnt : eliminate 
aeeiimnst : amenities 
aeeiinnoprrttt : interpretation 
aeeiinnoqrstu : questionnaire 
aeeiirstv : varieties 
aeeiklmuw : milwaukee 
aeeillnssty : essentially 
aeeillrtvy : relatively 
aeeillstt : satellite 
aeeilmnnnortv : environmental 
aeeilnntv : valentine 
aeeilnortv : revelation 
aeeilnotv : elevation 
aeeilnpst : penalties palestine 
aeeilnqtuv : equivalent 
aeeilnssst : essentials 
aeeilnsst : essential 
aeeilrr : earlier 
aeeilrrst : retailers 
aeeilrrt : retailer 
aeeilrrttu : literature 
aeeilrrtv : retrieval 
aeeilrst : earliest 
aeeilrstv : relatives 
aeeilrtv : relative 
aeeilrz : realize 
aeeimnsx : examines 
aeeimnx : examine 
aeeimrst : emirates 
aeeimsstt : estimates 
aeeimstt : estimate 
aeeinnoprsstt : presentations 
aeeinnoprstt : presentation 
aeeinnoprtt : penetration 
aeeinoprrstv : preservation 
aeeinorrsstv : reservations 
aeeinorrstv : reservation 
aeeinrrtvy : veterinary 
aeeinrsttt : interstate 
aeeirs : easier 
aeejlmrsu : jerusalem 
aeekprs : speaker 
aeekprss : speakers 
aeellmnppstu : supplemental 
aeellntuvy : eventually 
aeellrrtv : traveller 
aeelmpstt : templates 
aeelmpsx : examples 
aeelmptt : template 
aeelmpx : example 
aeelnrrs : learners 
aeelnrt : eternal 
aeelnrtv : relevant 
aeelnrtx : external 
aeelnrw : renewal 
aeelprsu : pleasure 
aeelps : please 
aeelrrstv : travelers 
aeelrrtv : traveler 
aeelrst : relates 
aeelrsv : several reveals 
aeelrt : relate 
aeelrv : reveal 
aeels : lease 
aeelstt : seattle 
aeelsv : leaves 
aeelv : leave 
aeemnnprt : permanent 
aeemnrsttt : treatments 
aeemnrsu : username 
aeemnrttt : treatment 
aeemnssssst : assessments 
aeemnsssst : assessment 
aeemnssttt : statements 
aeemnsttt : statement testament 
aeemosw : awesome 
aeemrssu : measures 
aeemrsu : measure 
aeenopru : european 
aeenpprssw : newspapers 
aeenpprsw : newspaper 
aeenrst : eastern nearest 
aeenrstv : veterans 
aeenrtv : veteran 
aeenst : senate 
aeenuv : avenue 
aeeoprst : operates 
aeeoprt : operate 
aeeorssv : overseas 
aeepprr : prepare 
aeeprt : repeat 
aeerrrstu : treasurer 
aeerrsstu : treasures 
aeerrstu : treasure 
aeerrtt : retreat 
aeerst : easter 
aees : ease 
aeesstt : estates 
aeestt : estate 
aefgilmnnu : meaningful 
aefginrtu : featuring 
aefglrtu : grateful 
aefgnoprt : frontpage 
aefgoot : footage 
aefhlrss : flashers 
aefhrst : fathers 
aefhrt : father 
aefiilmpr : amplifier 
aefiilms : families 
aefiimnortv : informative 
aefillrw : firewall 
aefilnooprss : professional 
aefilnooprsss : professionals 
aefilrsu : failures 
aefilru : failure 
aefilsstv : festivals 
aefilstv : festival 
aefimrrw : firmware 
aefiorstuv : favourites 
aefiorstv : favorites 
aefiortuv : favourite 
aefiortv : favorite 
aefirrr : ferrari 
aefk : fake 
aefkmorrw : framework 
aefl : leaf 
aeflln : fallen 
aeflm : flame 
aeflnnorttuuy : unfortunately 
aeflnru : funeral 
aefls : false 
aeflsy : safely 
aefm : fame 
aefmr : frame 
aefmrr : farmer 
aefmrrs : farmers 
aefmrs : frames 
aefnnoort : afternoon 
aefnrrsst : transfers 
aefnrrst : transfer 
aefooprrtw : waterproof 
aefoortw : footwear 
aeforstw : software 
aefr : fear fare 
aefrrs : fraser 
aefrs : fears fares safer 
aefrst : faster 
aefrt : after 
aefs : safe 
aefsstt : fastest 
aefsty : safety 
aeft : fate feat 
aeg : age 
aegg : gage 
aeggginn : engaging 
aeggglu : luggage 
aegghinrt : gathering 
aegghopry : geography 
aeggiinnrtt : integrating 
aeggimnss : messaging 
aeggior : georgia 
aeggmorst : mortgages 
aeggmort : mortgage 
aeggu : gauge 
aeghhoopprrst : photographers 
aeghhoopprrt : photographer 
aeghiln : healing 
aeghilr : raleigh 
aeghimnrt : nightmare 
aeghinnpp : happening 
aeghinr : hearing 
aeghinrs : hearings 
aeghint : heating 
aeghrt : gather 
aegiiinnossttv : investigations 
aegiiinnosttv : investigation 
aegiillnost : legislation 
aegiilnnpx : explaining 
aegiimn : imagine 
aegiimnnr : remaining 
aegiimnnx : examining 
aegiinnoostt : negotiations 
aegiinnoott : negotiation 
aegiinnortt : integration 
aegiinorrstt : registration 
aegiinorssttv : investigators 
aegiinorsttv : investigator 
aegiinr : nigeria 
aegikmnrt : marketing 
aegiknps : speaking 
aegilll : illegal 
aegillnrtv : travelling 
aegillsv : villages 
aegillv : village 
aegilmnnt : alignment 
aegilnnr : learning 
aegilnor : regional 
aegilnorstu : regulations 
aegilnortu : regulation 
aegilnos : gasoline 
aegilnrt : relating integral triangle 
aegilnrtv : traveling 
aegilns : leasing 
aegilnv : leaving 
aegim : image 
aegimnn : meaning 
aegimnnssst : assignments 
aegimnnsst : assignment 
aegimnpttt : attempting 
aegimnrst : streaming 
aegimnrsu : measuring 
aegims : images 
aeginnors : reasoning 
aeginnorw : norwegian 
aeginnprt : parenting 
aeginnr : earning 
aeginnrs : earnings 
aeginnrsw : answering 
aeginoprs : singapore 
aeginoprt : operating 
aeginorrz : organizer 
aeginorz : organize 
aeginpprr : preparing 
aeginpty : egyptian 
aeginrrs : earrings 
aeginrsstu : signatures 
aeginrstu : signature 
aeginrtt : treating 
aeginrw : wearing 
aeginssss : assessing 
aeginst : seating 
aegint : eating 
aegintv : vintage 
aeginu : guinea 
aegirrrst : registrar 
aegklnosvw : volkswagen 
aegl : gale 
aegll : legal 
aegllly : legally 
aegllrruy : regularly 
aegllry : gallery largely allergy 
aegln : angel angle 
aeglns : angels 
aeglnssssu : sunglasses 
aeglorrtuy : regulatory 
aeglotv : voltage 
aeglr : large 
aeglrr : larger 
aeglrru : regular 
aeglrst : largest 
aeglrty : greatly 
aeglsss : glasses 
aegm : game mega 
aegmmoprr : programme 
aegmmoprrr : programmer 
aegmmoprrrs : programmers 
aegmmoprrs : programmes 
aegmnr : german 
aegmnrstu : arguments 
aegmnrtu : argument 
aegmnry : germany 
aegmnt : magnet 
aegmo : omega 
aegmopst : gamespot 
aegms : games sagem 
aegnnprt : pregnant 
aegnor : orange 
aegnr : range anger 
aegnrr : ranger 
aegnrrs : rangers 
aegnrrst : stranger 
aegnrs : ranges 
aegnrst : strange 
aegnrw : wagner 
aegnst : agents 
aegnt : agent 
aegopst : postage 
aegorst : storage 
aegp : page 
aegpru : prague 
aegps : pages 
aegr : gear rage 
aegrstt : targets 
aegrstty : strategy 
aegrt : great 
aegrtt : target 
aegru : argue 
aegrv : grave 
aegs : ages sage sega 
aegsst : stages 
aegst : stage gates 
aegsu : usage 
aegsv : vegas 
aegsw : wages 
aegt : gate 
aegv : gave 
aegw : wage 
aehhimprs : hampshire 
aehhlt : health 
aehhlty : healthy 
aehht : heath 
aehiilnoprsst : relationships 
aehiilnoprst : relationship 
aehiimnstu : humanities 
aehiiopt : ethiopia 
aehiiorsttu : authorities 
aehiipstt : hepatitis 
aehillnsv : nashville 
aehilvy : heavily 
aehimpss : emphasis 
aehinpprrsst : partnerships 
aehinpprrst : partnership 
aehinppss : happiness 
aehint : hentai 
aehipprs : sapphire 
aehiprstt : therapist 
aehks : shake 
aehlmrt : thermal 
aehlry : harley 
aehlsy : ashley 
aehltw : wealth 
aehlw : whale 
aehmmr : hammer 
aehmnrs : sherman 
aehmostw : somewhat 
aehms : shame 
aehmttw : matthew 
aehnns : hansen 
aehnopsty : pantyhose 
aehnorstt : northeast 
aehnort : another 
aehnpp : happen 
aehnpps : happens 
aehnst : athens 
aehnv : haven 
aehossttu : southeast 
aehot : tahoe 
aehpprs : perhaps 
aehprr : harper 
aehprs : phrase 
aehprss : phrases 
aehprty : therapy 
aehps : phase shape 
aehpss : shapes phases 
aehr : hear 
aehrrt : rather 
aehrs : share 
aehrss : shares 
aehrsstuu : thesaurus 
aehrst : hearts 
aehrstt : threats 
aehrstv : harvest 
aehrsw : washer 
aehrt : heart earth 
aehrtt : threat 
aehrvy : harvey 
aehstux : exhaust 
aehsy : hayes 
aeht : heat hate 
aehtt : theta 
aehtw : wheat 
aehv : have 
aehvy : heavy 
aehy : yeah 
aeiiiinsttv : initiatives 
aeiiiinttv : initiative 
aeiiilmnnot : elimination 
aeiilmnnops : minneapolis 
aeiilmnosstt : testimonials 
aeiilmnprry : preliminary 
aeiilmpr : imperial 
aeiilnr : airline 
aeiilnrs : airlines 
aeiilqstu : qualities 
aeiilrs : israeli 
aeiimmrt : maritime 
aeiimmxz : maximize 
aeiimnnnorstttu : instrumentation 
aeiimnnortt : termination 
aeiimnostt : estimation 
aeiimnrtu : miniature 
aeiimntt : intimate 
aeiinnoortt : orientation 
aeiinnotvv : innovative 
aeiinoprtx : expiration 
aeiinqsttu : quantities 
aeiiprr : prairie 
aeijm : jamie 
aeikl : alike 
aeiklmnpr : permalink 
aeikmsst : mistakes 
aeikmst : mistake 
aeiknru : ukraine 
aeikns : kinase 
aeiknt : intake 
aeikt : katie 
aeilllrty : literally 
aeillmnosstuuy : simultaneously 
aeillmttuy : ultimately 
aeillnoptty : potentially 
aeilm : email 
aeilmmor : memorial 
aeilmnnrsttu : instrumental 
aeilmnooprtt : metropolitan 
aeilmnoot : emotional 
aeilmnr : mineral 
aeilmnrs : minerals 
aeilmnrst : terminals 
aeilmnrt : terminal 
aeilmoprrty : temporarily 
aeilms : emails 
aeilmss : melissa 
aeilmttu : ultimate 
aeiln : alien 
aeilnnpsu : peninsula 
aeilnnrt : internal 
aeilnooprtx : exploration 
aeilnoorrtuvy : revolutionary 
aeilnoprsty : personality 
aeilnoptt : potential 
aeilnorst : relations 
aeilnort : relation oriental 
aeilnosv : slovenia 
aeilnp : alpine 
aeilnpsx : explains 
aeilnpx : explain 
aeilnr : linear 
aeilnrstv : intervals 
aeilnrsuv : universal 
aeilnrtv : interval 
aeilnssst : stainless 
aeilpps : applies 
aeilqtuy : equality 
aeilrrst : trailers 
aeilrrt : trailer 
aeilrrty : literary 
aeilrs : israel serial 
aeilrt : retail 
aeilrtv : levitra 
aeilrty : reality 
aeilstuxy : sexuality 
aeilsy : easily 
aeilv : alive 
aeimmrssu : summaries 
aeimn : anime maine 
aeimnnoppstt : appointments 
aeimnnopptt : appointment 
aeimnnost : minnesota 
aeimnr : marine remain 
aeimnrs : remains seminar 
aeimnrss : seminars 
aeimnrtty : maternity 
aeimntv : vietnam 
aeimnty : anytime 
aeimoottuv : automotive 
aeimprv : vampire 
aeimpst : sitemap 
aeimr : marie 
aeimssv : massive 
aeinn : annie 
aeinnopsx : expansion 
aeinnottt : attention 
aeinnrtt : intranet 
aeinnv : vienna 
aeinooprst : operations 
aeinooprt : operation 
aeinoorrstt : restoration 
aeinoprttu : reputation 
aeinoqstu : equations 
aeinoqtu : equation 
aeinorstty : stationery 
aeinost : estonia 
aeinprs : persian 
aeinpst : panties 
aeinpstt : patients 
aeinptt : patient 
aeinqstu : antiques 
aeinqtu : antique 
aeinrrst : trainers 
aeinrrt : trainer terrain 
aeinrsstt : resistant 
aeinrt : retain 
aeintv : native 
aeintxy : anxiety 
aeiopprrrty : proprietary 
aeioprrrsty : respiratory 
aeiprr : repair 
aeiprrs : repairs 
aeiprs : praise 
aeiprst : parties pirates 
aeiprtv : private 
aeipssv : passive 
aeirrs : sierra 
aeirrsv : arrives 
aeirrv : arrive 
aeirs : raise arise 
aeirss : raises 
aeirsttv : travesti 
aeirsv : varies 
aeirtvy : variety 
aeirvw : waiver 
aejk : jake 
aejms : james 
aejn : jean jane 
aejns : jeans 
aejnt : janet 
aekl : lake 
aeklmrx : lexmark 
aeklrw : walker 
aekls : lakes 
aekm : make 
aekmnopss : spokesman 
aekmpu : makeup 
aekmr : maker 
aekmrr : marker remark 
aekmrrs : remarks markers 
aekmrs : makers 
aekmrst : markets 
aekmrt : market 
aekms : makes 
aeknor : korean 
aeknr : karen 
aeknrw : newark 
aekns : snake 
aeknt : taken 
aekny : kenya 
aekor : korea 
aekp : peak 
aekprr : parker 
aekps : speak 
aekpss : speaks 
aeks : sake 
aekst : takes stake 
aekt : take kate 
aekw : wake weak 
aellmrs : smaller 
aellmsst : smallest 
aelln : allen 
aellnoprsy : personally 
aellorv : overall 
aellquy : equally 
aellry : really 
aellsuxy : sexually 
aelltw : wallet 
aellty : lately 
aellvy : valley 
aelm : male meal 
aelmnort : montreal 
aelmnt : mental 
aelmny : namely 
aelmoprt : temporal 
aelmorv : removal 
aelmp : maple 
aelmpr : palmer 
aelmps : sample 
aelmpss : samples 
aelmr : realm 
aelmrv : marvel 
aelms : meals salem males 
aelmst : metals 
aelmsu : samuel 
aelmt : metal 
aeln : lane lean 
aelnnpr : planner 
aelnnprs : planners 
aelno : alone 
aelnoprs : personal 
aelnoprss : personals 
aelnors : orleans 
aelnp : panel plane nepal 
aelnps : panels planes naples 
aelnpst : planets 
aelnpt : planet 
aelnpty : penalty 
aelnr : learn 
aelnrst : rentals 
aelnrt : rental 
aelnrtu : neutral 
aelnru : lauren neural 
aelnry : nearly 
aelns : lanes 
aelnsty : stanley 
aelntt : talent 
aelorrst : realtors 
aelorrt : realtor 
aelp : pale 
aelpp : apple 
aelpr : pearl 
aelprsy : players 
aelpry : player 
aelpst : plates 
aelpt : plate 
aelqrrtuy : quarterly 
aelqu : equal 
aelr : real earl 
aelrry : rarely 
aelrs : laser 
aelrst : alerts 
aelrstv : travels 
aelrswy : lawyers 
aelrsy : layers 
aelrt : later alert alter 
aelrtt : latter 
aelrtv : travel 
aelrtw : walter 
aelrty : realty 
aelrwy : lawyer 
aelrx : relax 
aelry : early layer relay 
aelryy : yearly 
aels : sale seal 
aelss : sales 
aelst : least tales steal 
aelstt : latest 
aelsuv : values 
aelsux : sexual 
aelsv : slave 
aelsvv : valves 
aelsw : wales 
aelt : late tale 
aeltx : latex 
aeluv : value 
aelv : eval 
aelvv : valve 
aelx : alex 
aely : yale 
aem : mae 
aemm : emma 
aemmoorst : roommates 
aemmoort : roommate 
aemn : name mean 
aemnnorsttu : tournaments 
aemnnorttu : tournament 
aemnnr : manner 
aemnnw : newman 
aemnorty : monetary 
aemnory : anymore 
aemnpsty : payments 
aemnpty : payment 
aemnrsu : surname 
aemns : means names 
aemnt : meant 
aemoostt : tomatoes 
aemoprrty : temporary 
aempsttt : attempts 
aempttt : attempt 
aemrsst : masters streams 
aemrsstt : mattress 
aemrst : master stream 
aemrstt : matters 
aemrtt : matter 
aemrtu : mature 
aems : same mesa 
aemsssu : assumes 
aemssu : assume 
aemst : teams steam 
aemsx : exams 
aemt : team meat meta mate 
aemx : exam 
aenn : anne 
aennoy : anyone 
aenntt : tenant 
aennx : annex 
aenopsw : weapons 
aenopw : weapon 
aenors : reason 
aenorss : reasons 
aenorsst : senators 
aenorst : senator 
aenorstty : attorneys 
aenortty : attorney 
aenoss : season 
aenosss : seasons 
aenprrst : partners 
aenprrt : partner 
aenprst : parents 
aenprstt : patterns 
aenprt : parent 
aenprtt : pattern 
aenpssxy : expansys 
aenpstt : patents 
aenptt : patent 
aenr : near earn 
aenrrw : warren warner 
aenrssw : answers 
aenrsw : answer 
aenrtu : nature 
aens : sean 
aensv : evans 
aenwy : wayne 
aeooprrst : operators 
aeooprrt : operator 
aeoopstt : potatoes 
aeopprv : approve 
aeopr : opera 
aeoprstt : prostate 
aep : epa 
aeppr : paper 
aepprs : papers 
aepr : rape 
aeprrsy : prayers 
aeprry : prayer 
aeprs : spare 
aeprss : spears 
aeprswy : spyware 
aeps : peas 
aepsss : passes 
aepst : tapes paste 
aept : tape 
aeqrrstu : quarters 
aeqrrtu : quarter 
aeqrsu : square 
aer : are era ear 
aerr : rare rear 
aerrst : arrest 
aerrstt : starter 
aerrstuy : treasury 
aers : ears 
aerssu : assure 
aerst : rates tears 
aersttw : stewart 
aerstw : waters 
aerstx : extras 
aersv : saver 
aersy : years 
aert : rate tear 
aertt : treat 
aertty : treaty 
aertw : water 
aertx : extra 
aerw : wear ware 
aery : year 
aes : sea 
aess : seas 
aessss : assess 
aessst : assets 
aesssy : essays 
aesst : asset seats 
aesstt : states 
aesstttu : statutes 
aessv : saves 
aessy : essay 
aest : east seat 
aestt : state taste 
aestttu : statute 
aestw : waste 
aestx : texas taxes 
aesty : yeast 
aesv : save 
aesvw : waves 
aesy : easy 
aet : eat tea ate 
aeu : eau 
aev : ave eva 
aevw : wave 
aey : aye yea 
af : af fa 
affginst : staffing 
affiilnpt : plaintiff 
affinty : tiffany 
affirt : tariff 
affknrrtu : frankfurt 
affst : staff 
afghilns : flashing 
afgiiln : failing 
afgiilnquy : qualifying 
afgilln : falling 
afgilnot : floating 
afgimnortt : formatting 
afgimnr : farming framing 
afgl : flag 
afgls : flags 
afhinos : fashion 
afhit : faith 
afhl : half 
afhlmru : harmful 
afhls : flash 
afhst : shaft 
afiilnnot : inflation 
afiimnnoort : information 
afiklnnr : franklin 
afil : fail 
afillny : finally 
afilmnor : informal 
afilmy : family 
afiln : final 
afilnpu : painful 
afilns : finals 
afilquy : qualify 
afilry : fairly 
afils : fails 
afimnoort : formation 
afinnotu : fountain 
afinnst : infants 
afinnt : infant 
afir : fair 
afiry : fairy 
afissty : satisfy 
afknr : frank 
afll : fall 
afllor : floral 
aflls : falls 
aflmoprst : platforms 
aflmoprt : platform 
aflmor : formal 
aflmoru : formula 
aflorv : flavor 
aflot : float 
aflt : flat 
afltu : fault 
afluw : awful 
afmnorrst : transform 
afmo : foam 
afmorst : formats 
afmort : format 
afmosu : famous 
afmr : farm 
afmrs : farms 
afn : fan 
afns : fans 
aforsv : favors 
aforuv : favour 
aforv : favor 
afos : sofa 
afq : faq 
afqs : faqs 
afr : far 
afst : fast 
aft : fat 
aftty : fatty 
afx : fax 
ag : ga ag 
agghiiknnstv : thanksgiving 
agghilnu : laughing 
agghinn : hanging 
aggiimn : imaging 
aggiinnorz : organizing 
aggimmnoprr : programming 
aggimn : gaming 
aggin : aging 
agginnr : ranging 
agglosw : glasgow 
aggn : gang 
aghhiswy : highways 
aghhiwy : highway 
aghhlotu : although 
aghhoopprst : photographs 
aghhoopprt : photograph 
aghhoopprty : photography 
aghilmorst : algorithms 
aghilmort : algorithm 
aghimnnott : nottingham 
aghinnostw : washington 
aghinnty : anything 
aghinrs : sharing 
aghinsw : washing 
aghinv : having 
aghirstt : straight 
aghlnoooprty : anthropology 
aghloopty : pathology 
aghlu : laugh 
aghn : hang 
aghnruy : hungary 
aghntuy : naughty 
aghpr : graph 
aghprs : graphs 
aghttu : taught 
agiiilnott : litigation 
agiiimmnort : immigration 
agiiinorrt : irrigation 
agiiinrv : virginia 
agiillnnst : installing 
agiillnory : originally 
agiilmn : mailing 
agiilnor : original 
agiilns : sailing 
agiimmnrst : immigrants 
agiimnort : migration 
agiinnpst : paintings 
agiinnpt : painting 
agiinnrt : training 
agiinrs : raising arising 
agiintw : waiting 
agiklnt : talking 
agiklnw : walking 
agikmn : making 
agikmnr : marking 
agiknnps : spanking 
agiknnr : ranking 
agiknnrs : rankings 
agiknpr : parking 
agikns : asking 
agiknst : skating 
agiknt : taking 
agillnow : allowing 
agilmnoo : mongolia 
agilmnps : sampling 
agiln : align 
agilnnnp : planning 
agilnnort : arlington 
agilnppy : applying 
agilnpy : playing 
agilns : signal 
agilnss : signals 
agilnst : lasting 
agimnorss : organisms 
agimnpp : mapping 
agimnr : margin garmin 
agimnrw : warming 
agimnssu : assuming 
agimnt : mating 
agims : sigma 
agin : gain 
aginnnoy : annoying 
aginnrsw : warnings 
aginnrw : warning 
aginntw : wanting 
aginpprw : wrapping 
aginpss : passing 
aginpy : paying 
aginr : grain 
aginrrst : starring 
aginrst : ratings 
aginrstt : starting 
aginrt : rating 
aginrvy : varying 
agins : gains 
aginss : assign 
aginssv : savings 
aginst : giants 
aginstt : stating 
aginsty : staying 
aginsv : saving 
aginsy : saying 
agint : giant 
agirst : gratis 
agirstu : guitars 
agirttu : gratuit 
agirtu : guitar 
agirtvy : gravity 
agln : lang 
aglno : along logan 
aglo : goal 
agloorsty : astrology 
agloprtu : portugal 
aglorssy : glossary 
aglos : goals 
aglss : glass 
agm : mag 
agmno : among 
agmnor : morgan 
agmnorrst : armstrong 
agmnost : amongst 
agmnssu : samsung 
agmnstu : mustang 
agmoprr : program 
agmoprrs : programs 
agmors : orgasm 
agmrs : grams 
agmu : guam 
agnno : gonna 
agnnry : granny 
agnor : organ 
agnow : wagon 
agnrst : grants 
agnrt : grant 
agnry : angry 
agnw : wang 
agny : yang 
ago : ago 
agot : goat 
agott : gotta 
agoy : yoga 
agp : gap 
agps : gaps 
agr : arg 
agrs : gras 
agrss : grass 
agrsu : sugar 
agruuuy : uruguay 
agry : gray gary 
ags : gas 
agst : tags 
agstuu : august 
agsy : gays 
agt : tag 
agu : aug 
agv : avg 
agy : gay 
ah : ha ah 
ahhs : hash 
ahiiloopz : zoophilia 
ahiilopstty : hospitality 
ahiimnnosst : smithsonian 
ahiirrstt : arthritis 
ahiit : haiti 
ahillopsz : shopzilla 
ahilmnot : hamilton 
ahilmot : hotmail 
ahilnoortz : horizontal 
ahilopsst : hospitals 
ahilopst : hospital 
ahimntuy : humanity 
ahinorrs : harrison 
ahinpss : spanish 
ahiorttuy : authority 
ahiprs : parish 
ahir : hair 
ahirrs : harris 
ahiry : hairy 
ahit : thai 
ahjosu : joshua 
ahknst : thanks 
ahknt : thank 
ahkrs : shark 
ahkty : kathy 
ahkw : hawk 
ahll : hall 
ahlls : shall 
ahlo : halo 
ahlpr : ralph 
ahm : ham 
ahmnoopsttu : southampton 
ahmnopt : hampton phantom 
ahmnory : harmony 
ahmnsu : humans 
ahmnu : human 
ahmost : thomas 
ahmpstyy : sympathy 
ahmr : harm 
ahmrs : marsh 
ahmt : math 
ahnnnos : shannon 
ahnnoty : anthony 
ahnopsst : snapshot 
ahnors : sharon 
ahns : hans 
ahnt : than 
ahooy : yahoo 
ahorstu : authors 
ahortt : throat 
ahortu : author 
ahppy : happy 
ahprs : sharp 
ahpst : paths 
ahpt : path 
ahrrtu : arthur 
ahrry : harry 
ahrst : trash 
ahrt : hart 
ahs : has ash 
ahst : hats 
ahstt : thats 
ahstw : whats 
ahsw : wash shaw 
aht : hat 
ahtt : that 
ahtu : utah 
ahtw : what 
ahy : hay 
ai : ia ai 
aiiillnty : initially 
aiiilmnostt : limitations 
aiiilmnott : limitation 
aiiilnnostttu : institutional 
aiiilnottuz : utilization 
aiiilnt : initial 
aiiilprsttuy : spirituality 
aiiimnoopttz : optimization 
aiiinnoprst : inspiration 
aiiinnosttv : invitations 
aiiinnottv : invitation 
aiillmrsy : similarly 
aiillmsw : williams 
aiillmw : william 
aiillnorssttu : illustrations 
aiillnorsttu : illustration 
aiilmmn : minimal 
aiilmmnuu : aluminium 
aiilmnosstu : simulations 
aiilmnostu : simulation 
aiilmprry : primarily 
aiilmrs : similar 
aiilmrty : military 
aiilnnorttu : nutritional 
aiilnnostu : insulation 
aiilnoost : isolation 
aiilnoostv : violations 
aiilnootv : violation 
aiilnopv : pavilion 
aiilprstu : spiritual 
aiimm : miami 
aiimnnnoost : nominations 
aiimnnnoot : nomination 
aiimnnorssst : transmission 
aiimnoottv : motivation 
aiimnstv : vitamins 
aiimnttu : titanium 
aiimntv : vitamin 
aiimrstuu : mauritius 
aiinnnoostv : innovations 
aiinnnootv : innovation 
aiinnorstt : transition 
aiinnosv : invasion 
aiinoprtt : partition 
aiinossttu : situations 
aiinosttu : situation 
aiinrstuv : antivirus 
aiinstu : tunisia 
aiiqr : iraqi 
aiirtv : trivia 
aijl : jail 
aijlmnorsu : journalism 
aijlnorsstu : journalists 
aijlnorstu : journalist 
aijlnu : julian 
aijlu : julia 
aijmorty : majority 
aik : kai 
aikno : nokia 
aiknoorsttw : workstation 
aiktuw : kuwait 
ail : ali 
aillmoz : mozilla 
aillnst : install 
aillnsuv : sullivan 
aillot : lolita 
aillpsty : playlist 
aillrtuvy : virtually 
aillsv : villas 
aillv : villa 
ailm : mail mali 
ailmmnuu : aluminum 
ailmn : milan 
ailmnoooprt : promotional 
ailmnoprtty : importantly 
ailmnot : minolta 
ailmnptu : platinum 
ailmnry : marilyn 
ailmnu : alumni 
ailmny : mainly 
ailmopt : optimal 
ailmortty : mortality 
ailmot : mailto 
ailms : islam mails 
ailmt : tamil 
ailmuv : valium 
ailn : nail 
ailnnstty : instantly 
ailnooppstu : populations 
ailnoopptu : population 
ailnoopt : optional 
ailnot : latino 
ailnp : plain 
ailnps : plains 
ailns : nails 
ailnt : latin 
ailopprtuy : popularity 
ailorss : solaris 
ailorsttu : tutorials 
ailorttu : tutorial 
ailpr : april 
ailpx : paxil 
ailqtuy : quality 
ailr : rail 
ailrst : trials trails 
ailrsuvv : survival 
ailrt : trial trail 
ailrtuv : virtual 
ailrv : viral 
ails : lisa sail 
ailstuw : lawsuit 
ailsuv : visual 
ailt : tail 
ailtv : vital 
ailty : italy 
aim : aim mai mia 
aimmmux : maximum 
aimn : main 
aimnnostu : mountains 
aimnnotu : mountain 
aimno : amino 
aimnoprtt : important 
aimnopssstu : assumptions 
aimnopsstu : assumption 
aimnor : marion 
aimnrstt : transmit 
aimnrt : martin 
aimnstu : tsunami 
aimor : mario 
aimorrtt : marriott 
aimprry : primary 
aimrtx : matrix 
aims : aims 
aimu : maui 
ain : ian 
ainnoot : antonio 
ainnost : nations 
ainnot : nation 
ainnss : nissan 
ainnstt : instant 
ainooqsttu : quotations 
ainoort : ontario 
ainoortt : rotation 
ainop : piano 
ainopss : passion 
ainosstt : stations 
ainostt : station 
ainp : pain 
ainps : spain 
ainpt : paint 
ainqttuy : quantity 
ainr : rain iran 
ainrssu : russian 
ainrst : strain trains 
ainrstt : transit 
ainrt : train 
ains : asin 
ainsst : saints 
ainst : saint satin 
ainstt : titans 
ainstu : austin 
aint : anti 
aioprrst : airports 
aioprrstt : portraits 
aioprrt : airport 
aioprrtt : portrait 
aiopt : patio 
aiorrrsw : warriors 
aiorrrw : warrior 
aiorst : ratios 
aiorsuv : various 
aiort : ratio 
aioss : oasis 
aiow : iowa 
aip : api 
aipq : ipaq 
aipr : pair 
aiprs : paris pairs 
aipzz : pizza 
aiqr : iraq 
air : air ira 
airsstt : artists 
airssu : russia 
airstt : artist 
airstv : travis 
airsy : syria 
ais : isa 
aisssst : assists 
aissst : assist 
aistv : vista 
aisv : visa 
aisx : axis 
ait : ati 
aitw : wait 
aitx : taxi 
aiv : via avi 
aj : ja aj 
ajlnorsu : journals 
ajlnoru : journal 
ajm : jam 
ajmor : major 
ajn : jan 
ajno : joan 
ajnos : jason 
ajnu : juan 
ajr : jar 
ajy : jay 
ajzz : jazz 
ak : ak ka 
aklmoorst : looksmart 
aklosv : slovak 
aklr : karl 
aklst : talks 
aklsw : walks 
aklt : talk 
aklw : walk 
akmr : mark 
akmrs : marks 
akms : mask 
aknps : spank 
aknr : rank 
aknrs : ranks 
aknst : tanks 
aknt : tank 
ako : oak 
akorrtw : artwork 
akos : oaks 
akoy : okay 
akpr : park 
akprs : parks 
aks : ask 
akss : asks 
aksst : tasks 
akst : task 
aky : kay 
al : la al 
all : all 
allm : mall 
allmnory : normally 
allms : small 
alloop : apollo 
allopry : payroll 
allosw : allows 
allotty : totally 
allow : allow 
alloy : alloy 
allry : rally 
allsuuy : usually 
allsw : walls 
allsy : sally 
allt : tall 
allw : wall 
almnor : normal 
almnos : salmon 
almooort : motorola 
almor : moral 
almost : almost 
almp : palm lamp 
almps : lamps 
almrtu : ultram 
almsuy : asylum 
almtuu : mutual 
aln : lan 
alno : loan 
alnortuvy : voluntary 
alnos : loans salon 
alnp : plan 
alnps : plans 
alnpst : plants 
alnpt : plant 
alnsuuu : unusual 
alntuw : walnut 
alnw : lawn 
alo : aol 
aloopprs : proposal 
aloopprss : proposals 
aloppru : popular 
aloppst : laptops 
aloppt : laptop 
alopr : polar 
aloprt : portal patrol 
alopst : postal 
alor : oral 
alors : solar 
alorty : taylor 
alortyy : royalty 
alory : royal 
alos : also laos 
alostt : totals 
alot : alto alot 
alott : total 
alotuy : layout 
alov : oval 
alp : pal lap 
alppy : apply 
alprty : partly 
alpsy : plays 
alpu : paul 
alpy : play 
alrru : rural 
alrry : larry 
alrtu : ultra 
als : las 
alst : last salt 
alstu : tulsa 
alsuu : usual 
alsw : laws 
alt : lat alt 
altuv : vault 
altw : walt 
alv : val 
alw : law wal 
aly : lay 
alyz : lazy 
am : am ma 
ammrsuy : summary 
amn : man nam 
amnnoosuy : anonymous 
amnnor : norman 
amno : oman 
amnoorsty : astronomy 
amnor : roman manor 
amnos : mason 
amnostu : amounts 
amnotu : amount 
amnow : woman 
amnqtuu : quantum 
amnr : mrna 
amntuu : autumn 
amny : many 
amoott : tomato 
amorr : armor 
amory : mayor 
amos : soma 
amot : atom 
amp : map amp pam 
amps : maps spam 
ampsst : stamps 
ampst : stamp 
amr : mar ram arm 
amrruy : murray 
amrs : arms mars 
amrst : smart 
amrt : mart 
amrw : warm 
amry : mary army 
ams : sam mas 
amss : mass 
amst : mats 
amt : mat atm 
amtt : matt 
amw : wma 
amx : max 
amy : may amy 
an : an na 
ann : ann 
anno : nano 
annrty : tranny 
anoprrstt : transport 
anorrw : narrow 
anorwy : norway 
anostw : watson 
anosy : sanyo 
anot : nato 
anov : nova avon 
anp : pan 
anprstuu : pursuant 
anpruw : unwrap 
anps : span snap 
anpst : pants 
anr : ran rna 
anrst : trans 
anrstu : saturn 
anry : ryan yarn 
ans : san asn 
anss : sans 
anssu : susan 
anst : stan 
anstw : wants 
anstxy : syntax 
ansty : nasty 
ant : tan nat ant 
antw : want 
anu : una 
anv : van nav 
anvy : navy 
anw : wan 
any : any 
aooptt : potato 
aoottt : tattoo 
aootty : toyota 
aopprsst : passport 
aopprx : approx 
aoprst : pastor 
aops : soap paso 
aorrty : rotary 
aorrw : arrow 
aors : rosa 
aorstttuy : statutory 
aos : sao soa 
aostu : autos 
aotu : auto 
ap : pa ap 
app : app 
apps : apps 
apr : apr par rap 
aprst : parts strap 
aprsttu : startup 
aprsy : spray 
aprt : part trap 
aprty : party 
aprw : wrap 
apry : pray 
aps : spa asp sap pas 
apss : pass spas 
apst : past 
apsw : swap 
apsy : pays 
apt : pat tap apt 
apy : pay 
ar : ar ra 
arsst : stars 
arsstt : starts 
arst : star arts rats 
arstt : start 
arsttu : stuart 
arsw : wars 
arsy : rays 
art : art rat tar 
arty : tray 
arv : var 
arvy : vary 
arw : war raw 
ary : ray 
as : as sa 
ass : ass sas 
asstt : stats 
assttu : status 
assty : stays 
assu : asus 
assy : says 
ast : sat 
astt : stat 
asttw : watts 
astv : vast 
asty : stay 
asu : usa aus 
asw : was saw 
aswy : ways 
asy : say 
at : at ta 
attw : watt 
atv : vat 
atx : tax 
au : au 
av : va av 
avw : wav 
aw : wa aw 
awx : wax 
awy : way 
ay : ya 
az : az za 
b : b 
bb : bb 
bbbelu : bubble 
bbboy : bobby 
bbc : bbc 
bbceinrssuu : unsubscribe 
bbceirrsssu : subscribers 
bbceirrssu : subscriber 
bbceirssu : subscribe 
bbchuy : chubby 
bbeglmoor : bloomberg 
bbehios : hobbies 
bbeil : bible 
bbeior : robbie 
bberru : rubber 
bbhoy : hobby 
bbhpp : phpbb 
bbinor : ribbon 
bbjloosw : blowjobs 
bbjloow : blowjob 
bbloy : lobby 
bbmo : bomb 
bbo : bob 
bboo : boob 
bboos : boobs 
bbs : bbs 
bbw : bbw 
bc : bc cb 
bcceehilprtu : techrepublic 
bcceeilllost : collectibles 
bcceeilllot : collectible 
bcceily : bicycle 
bcciu : cubic 
bcddeeirs : described 
bcdeeemr : december 
bcdeeiilmorrstuy : sublimedirectory 
bcdeeiilnr : incredible 
bcdeeiprrs : prescribed 
bcdeeirs : describe 
bcdeeirss : describes 
bcdegiinrs : describing 
bcdeimno : combined 
bcdeinorttu : contributed 
bcdeklo : blocked 
bceeeiilrst : celebrities 
bceeijostv : objectives 
bceeijotv : objective 
bceeijstuv : subjective 
bceeilnortv : convertible 
bceeilrty : celebrity 
bceeimmosttu : subcommittee 
bceels : celebs 
bceemo : become 
bceemos : becomes 
bceequ : quebec 
bceghilnoooty : biotechnology 
bcegimno : becoming 
bcehn : bench 
bcehorrsu : brochures 
bcehorru : brochure 
bceilpru : republic 
bceimno : combine 
bceimnos : combines 
bceinorttu : contribute 
bceinosstu : subsection 
bcejost : objects 
bcejot : object 
bcejsstu : subjects 
bcejstu : subject 
bceoort : october 
bceru : bruce 
bcery : cyber 
bceu : cube 
bcgiilmn : climbing 
bcgiimnno : combining 
bcgiinnorttu : contributing 
bcgiklno : blocking 
bchit : bitch 
bchnu : bunch 
bciilptuy : publicity 
bciinnoorsttu : contributions 
bciinnoorttu : contribution 
bciinoprssstu : subscriptions 
bciinoprsstu : subscription 
bciknrsuw : brunswick 
bcikr : brick 
bcillpuy : publicly 
bcilm : climb 
bcilpu : public 
bcinoorrsttu : contributors 
bcinoorrttu : contributor 
bcjst : sbjct 
bckkoooo : cookbook 
bcklo : block 
bcklos : blocks 
bcksu : bucks 
bcku : buck 
bclmosuu : columbus 
bclsu : clubs 
bclu : club 
bcmoo : combo 
bcn : nbc 
bco : boc 
bcoowy : cowboy 
bcs : cbs 
bd : db bd 
bdddeeem : embedded 
bddefinor : forbidden 
bddefor : bedford 
bddegin : bedding 
bddeiirsttu : distributed 
bddeir : bidder 
bddeirstu : disturbed 
bddgiin : bidding 
bdduy : buddy 
bde : bed 
bdeeeemmrr : remembered 
bdeeeilv : believed 
bdeefhirrsu : refurbished 
bdeefrs : freebsd 
bdeegiln : bleeding 
bdeeginr : breeding 
bdeeis : beside 
bdeeiss : besides 
bdeelss : blessed 
bdeeorsv : observed 
bdeeorvyy : everybody 
bdeer : breed 
bdeers : breeds 
bdeghhinooor : neighborhood 
bdeghinru : edinburgh 
bdegir : bridge 
bdegirs : bridges 
bdegstu : budgets 
bdegtu : budget 
bdegu : debug 
bdehiioprt : prohibited 
bdehilpsu : published 
bdehin : behind 
bdeiiiorstvy : biodiversity 
bdeiirsttu : distribute 
bdeilrsu : builders 
bdeilru : builder 
bdeimsttu : submitted 
bdeios : bodies 
bdeir : bride 
bdeiru : buried 
bdeln : blend 
bdelno : blonde 
bdelnu : bundle 
bdeloru : boulder 
bdelou : double 
bdemoor : bedroom 
bdemoors : bedrooms 
bdemoosy : somebody 
bdempu : pubmed 
bden : bend 
bdenoru : rebound 
bdenoy : beyond 
bdenru : burden 
bdeor : bored 
bdeorr : border 
bdeorrs : borders 
bdeox : boxed 
bdery : derby 
bdes : beds 
bdet : debt 
bdetu : debut 
bdgiilnsu : buildings 
bdgiilnu : building 
bdgiinn : binding 
bdhiry : hybrid 
bdi : bid 
bdiiinorssttu : distributions 
bdiiinorsttu : distribution 
bdiiinossuv : subdivision 
bdiiorrssttu : distributors 
bdiiorrsttu : distributor 
bdiln : blind 
bdilnu : dublin 
bdilsu : builds 
bdilu : build 
bdin : bind 
bdir : bird 
bdirs : birds 
bdis : bids 
bdlno : blond 
bdlo : bold 
bdloo : blood 
bdlooy : bloody 
bdlv : blvd 
bdms : bdsm 
bdmu : dumb 
bdno : bond 
bdnooy : nobody 
bdnos : bonds 
bdnou : bound 
bdotu : doubt 
bdoy : body 
be : be 
bee : bee 
beeeilsv : believes 
beeeilv : believe 
beeeklry : berkeley 
beeellrssst : bestsellers 
beeelmns : ensemble 
beeemmrr : remember 
beeemprst : september 
beeentw : between 
beef : beef 
beefil : belief 
beefillx : flexible 
beefils : beliefs 
beefinst : benefits 
beefint : benefit 
beefor : before 
beegiill : eligible 
beeginnr : beginner 
beeginnrs : beginners 
beegnoorrs : greensboro 
beegprrstu : petersburg 
beehimmprs : membership 
beehrty : thereby 
beehrw : hebrew 
beehry : hereby 
beeiiiilnoprssst : responsibilities 
beeilnoprss : responsible 
beeilrrt : terrible 
beeilz : belize 
beeinssssu : businesses 
beeinw : newbie 
beeisstw : websites 
beeistw : website 
beell : belle 
beelmnoru : melbourne 
beelnqsstuuy : subsequently 
beelr : rebel 
beelrvy : beverly 
beemmr : member 
beemmrs : members 
beemnorv : november 
been : been 
beenntt : bennett 
beenqsstuu : subsequent 
beenrttu : brunette 
beeorrsv : observer 
beeorsv : observe 
beeoruvwy : voyeurweb 
beer : beer 
beerstw : webster 
beertt : better 
bef : feb 
beffru : buffer 
befgiinr : briefing 
befiiilltxy : flexibility 
befilry : briefly 
befir : brief fiber fibre 
befirs : briefs 
beflrttuy : butterfly 
befors : forbes 
beggiinnn : beginning 
beggir : bigger 
beggist : biggest 
begglor : blogger 
begglors : bloggers 
beghilnooorsttu : troubleshooting 
beghinor : neighbor 
beghinors : neighbors 
begiiiillty : eligibility 
begiijn : beijing 
begilmu : belgium 
begilrt : gilbert 
begin : being begin 
begins : begins beings 
begintt : betting 
begkoostu : guestbook 
beglmoruux : luxembourg 
beglno : belong 
beglnos : belongs 
beglo : globe 
beglosw : weblogs 
beglow : weblog 
begnu : begun 
behiiinostx : exhibitions 
behiiinotx : exhibition 
behiistx : exhibits 
behiitx : exhibit 
behilorr : horrible 
behilprssu : publishers 
behilprsu : publisher 
behloottu : bluetooth 
behorrst : brothers 
behorrt : brother 
behort : bother 
behosstw : webshots 
behr : herb 
behrs : herbs 
beht : beth 
beiiiilopssst : possibilities 
beiiilmqruu : equilibrium 
beiiilnoprssty : responsibility 
beiiilnsv : invisible 
beiilmopss : impossible 
beiilsv : visible 
beik : bike 
beikln : belkin 
beiks : bikes 
beillntu : bulletin 
beillntuv : vbulletin 
beilmo : mobile 
beilmos : mobiles 
beilmsu : sublime 
beilnr : berlin 
beilopss : possible 
beilrty : liberty 
beimrt : timber 
beinrtu : tribune 
beinrty : britney 
beinru : brunei 
beinsssu : business 
beioqtuu : boutique 
beiosty : obesity 
beirst : tribes 
beirt : tribe 
beirttu : tribute 
beisstttuu : substitute 
beit : bite 
beknooost : notebooks 
beknooot : notebook 
beknor : broken 
bekoo : ebook 
bekooorst : bookstore 
bekoos : ebooks 
bekoosttx : textbooks 
bekoottx : textbook 
bekor : broke 
bekorr : broker 
bekorrs : brokers 
bekru : burke 
bell : bell 
belltu : bullet 
belly : belly 
belmopr : problem 
belmoprs : problems 
belmrt : trembl 
belno : noble 
belortu : trouble 
belostt : bottles 
belott : bottle 
below : below 
belrsssu : brussels 
belrtu : butler 
belss : bless 
belst : belts 
belstu : subtle 
belsu : blues 
belt : belt 
belu : blue 
bemnrsu : numbers 
bemnru : number 
bempru : bumper 
ben : ben enb 
beno : bone 
benoorrst : robertson 
benorz : bronze 
benos : bones 
benoy : ebony 
benrru : burner 
bent : bent 
benz : benz 
beopr : probe 
beoqtuu : bouquet 
beorrssw : browsers 
beorrst : roberts 
beorrsw : browser 
beorrt : robert 
beorsw : browse 
beosx : boxes 
beprsu : superb 
berry : berry 
bersuy : buyers 
berttu : butter 
beruy : buyer 
bessu : buses 
best : best 
bestu : tubes 
besty : bytes 
bet : bet 
betty : betty 
betu : tube 
bety : byte 
bew : web 
bey : bye 
bfginu : bufing 
bfi : fbi 
bfu : buf 
bg : gb bg 
bgggilno : blogging 
bggiinnr : bringing 
bghiilnpsu : publishing 
bghilotx : lightbox 
bghinort : brighton 
bghiprsttu : pittsburgh 
bghirt : bright 
bghm : gmbh 
bghooru : borough 
bghortu : brought 
bghotu : bought 
bgi : big 
bgiilln : billing 
bgiimnsttu : submitting 
bgiknoo : booking 
bgiknoos : bookings 
bgilmnpu : plumbing 
bgilnnortu : burlington 
bgilnow : bowling blowing 
bgilooy : biology 
bginnru : burning 
bgino : bingo 
bginor : boring 
bginorsw : browsing 
bginos : gibson 
bginox : boxing 
bginr : bring 
bginrs : brings 
bginuy : buying 
bglo : blog 
bglos : blogs 
bgp : gbp 
bgruy : rugby 
bgsu : bugs 
bgu : bug 
bh : hb 
bhiiimsstu : mitsubishi 
bhiirst : british 
bhilpsu : publish 
bhiops : bishop 
bhirt : birth 
bhmstu : thumbs 
bhmtu : thumb 
bhoot : booth 
bhot : both 
bhrsu : brush 
bhsu : bush 
bhu : hub 
bi : bi 
biiiilstvy : visibility 
biiikn : bikini 
biiilopssty : possibility 
biillno : billion 
biilmoty : mobility 
biimnossssu : submissions 
biimnosssu : submission 
bikln : blink 
biknoprtu : uniprotkb 
bil : lib 
bill : bill 
bills : bills 
billy : billy 
bilo : biol 
biloosuvy : obviously 
bilopssy : possibly 
bilorst : bristol 
bils : libs 
biltu : built 
bim : ibm 
bimstu : submit 
bin : bin 
binnoors : robinson 
binor : robin 
binox : inbox 
bins : isbn 
bio : bio 
bioosuv : obvious 
biort : orbit 
bios : bios 
bist : bits 
bit : bit 
biz : biz 
bjo : job obj 
bjos : jobs 
bk : kb bk 
bklnoory : brooklyn 
bklu : bulk 
bkoo : book 
bkoor : brook 
bkoors : brooks 
bkoos : books 
bl : lb bl 
bllu : bull 
blm : mlb 
blmoo : bloom 
blmossy : symbols 
blmosy : symbol 
bloo : bool 
bloootx : toolbox 
blot : bolt 
blow : blow bowl 
bls : lbs 
bm : mb bm 
bmoo : boom 
bmoott : bottom 
bmw : bmw 
bn : nb 
bnnuy : bunny 
bno : bon 
bnoost : boston 
bnor : born 
bnortu : burton 
bnorw : brown 
bnosttu : buttons 
bnosu : bonus 
bnottu : button 
bnrsu : burns 
bnru : burn 
bo : bo ob 
boorst : robots 
boort : robot 
boost : boots boost 
boot : boot 
booty : booty 
bor : rob 
borstu : robust 
bortu : turbo 
boss : boss 
bosy : boys 
bow : bow 
box : box 
boxx : xbox 
boy : boy 
bp : bp pb 
bpsu : pubs 
bpu : pub 
br : br rb 
brstu : burst 
bruy : ruby 
bs : sb bs 
bsttu : butts 
bstuy : busty 
bsu : usb sub bus 
bsuy : busy buys 
bt : bt tb 
bttu : butt 
btu : but tub 
buy : buy 
buzz : buzz 
bv : vb 
bw : wb bw 
by : by 
c : c 
cc : cc 
ccceenorru : occurrence 
ccceinnottu : connecticut 
ccd : ccd 
ccddelnou : concluded 
ccddenotu : conducted 
ccdeeennooprrs : correspondence 
ccdeefinno : confidence 
ccdeehk : checked 
ccdeeiinn : incidence 
ccdeellot : collected 
ccdeennor : concerned 
ccdeennot : connected 
ccdeeorrt : corrected 
ccdeesu : succeed 
ccdeimnoorstu : semiconductor 
ccdeinnov : convinced 
ccdeinotv : convicted 
ccdeiopu : occupied 
ccdelnou : conclude 
ccdenorsttu : constructed 
ccdeorru : occurred 
ccdginnotu : conducting 
ccdnoor : concord 
ccdnotu : conduct 
cceeeellnx : excellence 
cceeefnnor : conference 
cceeefnnors : conferences 
cceeegnnorv : convergence 
cceeeinnnov : convenience 
cceeemmor : ecommerce 
cceeennoqssu : consequences 
cceeennoqsu : consequence 
cceeffiiny : efficiency 
cceefginnnor : conferencing 
cceeiilrtty : electricity 
cceeillotv : collective 
cceeiln : licence 
cceeilnorst : electronics 
cceeilnort : electronic 
cceeilrt : electric 
cceeinostuv : consecutive 
cceeinrrsu : currencies 
cceeins : science 
cceeinss : sciences 
cceemmor : commerce 
cceenort : concrete 
ccefiiinst : scientific 
ccefiips : specific 
ccefiipss : specifics 
ccefllsssuuy : successfully 
cceflsssuu : successful 
cceghikn : checking 
ccegillnot : collecting 
ccegilnry : recycling 
cceginnnor : concerning 
cceginnnot : connecting 
ccehhrsu : churches 
ccehiklst : checklist 
ccehikn : chicken 
ccehilnor : chronicle 
ccehilnors : chronicles 
ccehio : choice 
ccehios : choices 
ccehk : check 
ccehkotu : checkout 
ccehks : checks 
ccehz : czech 
cceiinnottvy : connectivity 
cceikrt : cricket 
cceillnoost : collections 
cceillnoot : collection 
cceilr : circle 
cceilrs : circles 
cceilt : celtic 
cceimnoo : economic 
cceimnoos : economics 
cceimosst : cosmetics 
cceimost : cosmetic 
cceinnnoost : connections 
cceinnnoot : connection 
cceinnoorrsttu : reconstruction 
cceinnoossssu : consciousness 
cceinnossty : consistency 
cceinoorrst : corrections 
cceinoorrt : correction 
cceinorrt : incorrect 
cceins : scenic 
ccelloorst : collectors 
ccelloort : collector 
ccellot : collect 
ccelmoorsty : motorcycles 
ccelmoorty : motorcycle 
ccelorrty : correctly 
ccelsy : cycles 
ccely : cycle 
ccennoorst : connectors 
ccennoort : connector 
ccennor : concern 
ccennors : concerns 
ccennot : connect 
ccenopst : concepts 
ccenopt : concept 
ccenorst : concerts 
ccenort : concert 
ccenrruy : currency 
cceorrt : correct 
cceors : soccer 
ccesssu : success 
ccf : fcc 
ccfilnost : conflicts 
ccfilnot : conflict 
ccg : gcc 
ccgiikln : clicking 
ccgilny : cycling 
ccginorru : occurring 
cchhru : church 
cchik : chick 
cchiks : chicks 
cchinor : chronic 
cchku : chuck 
cciiimrst : criticism 
cciiln : clinic 
cciilns : clinics 
cciinnootv : conviction 
cciinp : picnic 
cciirst : critics 
cciirstu : circuits 
cciirtu : circuit 
cciiv : civic 
ccijnnnootu : conjunction 
ccikl : click 
ccikls : clicks 
ccilmrruuu : curriculum 
ccilnnoossu : conclusions 
ccilnnoosu : conclusion 
ccilnosu : councils 
ccilnou : council 
ccimo : comic 
ccimos : comics 
ccinnoorsttu : construction 
ccinoossu : conscious 
ccios : cisco 
ccirsu : circus 
ccklo : clock 
ccklos : clocks 
ccko : cock 
cckos : cocks 
cclo : oclc 
ccmooor : morocco 
ccnorsttu : construct 
ccorsu : occurs 
ccoru : occur 
cd : cd dc 
cdddeei : decided 
cddeeeeinnnp : independence 
cddeeeennp : dependence 
cddeeemmnor : recommended 
cddeeett : detected 
cddeeginns : descending 
cddeehlsu : scheduled 
cddeei : decide 
cddeeiln : declined 
cddeeinors : considered 
cddeeiorsv : discovered 
cddeeiprt : predicted 
cddeeirt : directed 
cddeelux : excluded 
cddeemnotu : documented 
cddeeoprru : reproduced 
cddeeorr : recorded 
cddeeru : reduced 
cddehnooory : hydrocodone 
cddeilnu : included 
cddeinortu : introduced 
cddeinostu : discounted 
cddeinu : induced 
cddeisssu : discussed 
cddeopru : produced 
cddhhiloo : childhood 
cde : dec 
cdeeeefnrr : referenced 
cdeeeeinprx : experienced 
cdeeeffinr : difference 
cdeeeffinrs : differences 
cdeeeflrt : reflected 
cdeeefn : defence 
cdeeeinrs : residence 
cdeeeinrsw : widescreen 
cdeeeinv : evidence 
cdeeeiprv : perceived 
cdeeeirv : received 
cdeeeittv : detective 
cdeeejrt : rejected 
cdeeelst : selected 
cdeeelt : elected 
cdeeemrs : mercedes 
cdeeennortu : encountered 
cdeeenptux : unexpected 
cdeeenrt : centered 
cdeeeorrv : recovered 
cdeeeprst : respected 
cdeeeptx : expected 
cdeeetux : executed 
cdeeex : exceed 
cdeefiips : specified 
cdeefiirt : certified 
cdeefikrr : frederick 
cdeefilnnu : influenced 
cdeefint : infected 
cdeefst : defects 
cdeeginopr : proceeding 
cdeeginoprs : proceedings 
cdeeginors : recognised 
cdeeginorz : recognized 
cdeeginpr : preceding 
cdeehlssu : schedules 
cdeehlsu : schedule 
cdeehstu : deutsche 
cdeeiimn : medicine 
cdeeiimns : medicines 
cdeeiiorrst : directories 
cdeeiirtv : directive 
cdeeiln : decline 
cdeeilns : licensed 
cdeeinoprv : providence 
cdeeinott : detection 
cdeeioprrtuv : reproductive 
cdeeirrstt : restricted 
cdeeirst : discrete 
cdeeisv : devices 
cdeeitx : excited 
cdeeiv : device 
cdeejoprt : projected 
cdeelmopt : completed 
cdeelnos : enclosed 
cdeelux : exclude 
cdeemmnor : recommend 
cdeemmnors : recommends 
cdeemmnot : commented 
cdeemoprss : compressed 
cdeenortv : converted 
cdeent : decent 
cdeeopr : proceed 
cdeeoprrsu : procedures 
cdeeoprru : procedure reproduce 
cdeeoprs : proceeds 
cdeeoprss : processed 
cdeeoprtt : protected 
cdeeorrr : recorder 
cdeeorrrs : recorders 
cdeeortt : detector 
cdeeorv : covered 
cdeepsstu : suspected 
cdeersu : secured reduces 
cdeeru : reduce 
cdeett : detect 
cdeffiiilstu : difficulties 
cdefginoru : configured 
cdefiit : deficit 
cdefimnor : confirmed 
cdefinnot : confident 
cdefku : fucked 
cdefnosu : confused 
cdefor : forced 
cdefosu : focused 
cdeghilnsu : scheduling 
cdeghioprty : copyrighted 
cdegiinnors : considering 
cdegilnux : excluding 
cdeginno : encoding 
cdeginnooprrs : corresponding 
cdeginorr : recording 
cdeginorrs : recordings 
cdeginru : reducing 
cdehilnr : children 
cdehilnrs : childrens 
cdehistw : switched 
cdehotu : touched 
cdehstu : deutsch 
cdei : dice 
cdeiiilnps : discipline 
cdeiiilnpss : disciplines 
cdeiilosu : delicious 
cdeiimmoost : commodities 
cdeiinnst : incidents 
cdeiinnt : incident 
cdeiinoprsst : descriptions 
cdeiinoprst : description predictions 
cdeiinoprt : prediction 
cdeiinorst : directions discretion 
cdeiinort : direction 
cdeiinos : decision 
cdeiinoss : decisions 
cdeiinrt : indirect 
cdeiins : indices 
cdeiiopr : periodic 
cdeiisu : suicide 
cdeik : dicke 
cdeikp : picked 
cdeikw : wicked 
cdeilmop : compiled 
cdeilnry : cylinder 
cdeilnsu : includes 
cdeilnu : include 
cdeilorssu : disclosure 
cdeiloss : disclose 
cdeilrty : directly 
cdeimmott : committed 
cdeimost : domestic 
cdeimostuz : customized 
cdeinnotu : continued 
cdeinooprrtu : reproduction 
cdeinors : consider 
cdeinorss : considers 
cdeinorsttu : destruction 
cdeinorstu : introduces reductions 
cdeinort : doctrine 
cdeinortu : reduction introduce 
cdeinot : noticed 
cdeinrru : incurred 
cdeiop : copied 
cdeioprtuv : productive 
cdeiorrst : directors 
cdeiorrt : director 
cdeiorrty : directory 
cdeiorsv : discover 
cdeiorsvy : discovery 
cdeiorv : divorce 
cdeipr : priced 
cdeiprt : predict 
cdeirst : credits 
cdeirt : credit direct 
cdeissssu : discusses 
cdeit : cited 
cdek : deck 
cdeklo : locked 
cdekoo : cooked 
cdellnoort : controlled 
cdeloor : colored 
cdelopu : coupled 
cdelorss : cordless 
cdelos : closed 
cdemnostu : documents 
cdemnotu : document 
cdemoops : composed 
cdemoptu : computed 
cdemoy : comedy 
cdenos : second 
cdenoss : seconds 
cdenotu : counted 
cdeo : code oecd 
cdeoprrsu : producers 
cdeoprru : producer 
cdeoprsu : produces 
cdeopru : produce 
cdeor : decor 
cdeorr : record 
cdeorrs : records 
cdeors : scored 
cdeos : codes 
cderrsttuu : structured 
cderu : crude 
cdffiiltu : difficult 
cdffiiltuy : difficulty 
cdgiiinnnoot : conditioning 
cdgiilnnu : including 
cdgiinnortu : introducing 
cdgiinsssu : discussing 
cdgino : coding 
cdginopru : producing 
cdhil : child 
cdhimnor : richmond 
cdhtu : dutch 
cdiiijnorstu : jurisdiction 
cdiiinnostt : distinction 
cdiinnoorttu : introduction 
cdiinnoost : conditions 
cdiinnoot : condition 
cdiinnotu : induction 
cdiinossssu : discussions 
cdiinosssu : discussion 
cdiinstt : distinct 
cdiioprttuvy : productivity 
cdiirsstt : districts 
cdiirstt : district 
cdik : dick 
cdiks : dicks 
cdimmooty : commodity 
cdinooprstu : productions 
cdinooprtu : production 
cdinoorrttuy : introductory 
cdinosstu : discounts 
cdinostu : discount 
cdiny : cindy 
cdios : disco 
cdis : disc 
cdiss : discs 
cdisssu : discuss 
cdko : dock 
cdku : duck 
cdl : lcd 
cdlo : cold 
cdlosu : clouds 
cdlou : could cloud 
cdlouy : cloudy 
cdmnoopsu : compounds 
cdmnoopu : compound 
cdnoo : condo 
cdnoos : condos 
cdo : doc cod 
cdoorrssw : crossword 
cdoorst : doctors 
cdoort : doctor 
cdoprstu : products 
cdoprtu : product 
cdor : cord 
cdorw : crowd 
cdos : docs 
cdostuy : custody 
cds : cds dsc 
cdt : cdt 
ce : ce ec 
ceeeeffinsstv : effectiveness 
ceeeefinnrrt : interference 
ceeeefnprr : preference 
ceeeefnprrs : preferences 
ceeeefnrr : reference 
ceeeefnrrs : references 
ceeeeinprsx : experiences 
ceeeeinprx : experience 
ceeeffiltvy : effectively 
ceeeffitv : effective 
ceeefinqrsu : frequencies 
ceeefl : fleece 
ceeefmnnort : enforcement 
ceeegiillnnt : intelligence 
ceeegiinnprx : experiencing 
ceeegmnry : emergency 
ceeegr : greece 
ceeehiilnnstt : liechtenstein 
ceeehimnoprsv : comprehensive 
ceeehpss : speeches 
ceeehs : cheese 
ceeeilprstvy : respectively 
ceeeilstv : selective 
ceeeimnttx : excitement 
ceeeinstx : existence 
ceeeipprsstv : perspectives 
ceeeipprstv : perspective 
ceeeiprstv : respective 
ceeeirrsv : receivers 
ceeeirrv : receiver 
ceeeirssx : exercises 
ceeeirsv : receives 
ceeeirsx : exercise 
ceeeirv : receive 
ceeeissvx : excessive 
ceeeistuvx : executives 
ceeeituvx : executive 
ceeellntx : excellent 
ceeelopst : telescope 
ceeemrty : cemetery 
ceeennsst : sentences 
ceeennst : sentence 
ceeenprs : presence 
ceeenqssu : sequences 
ceeenqsu : sequence 
ceeenss : essence 
ceeetux : execute 
ceeffiilnty : efficiently 
ceeffiint : efficient 
ceeffo : coffee 
ceeffst : effects 
ceefft : effect 
ceefiipss : specifies 
ceefilnnsu : influences 
ceefilnnu : influence 
ceefilnorst : reflections 
ceefilnort : reflection 
ceeflnor : florence 
ceeflprty : perfectly 
ceeflrst : reflects 
ceeflrt : reflect 
ceefn : fence 
ceefnqruy : frequency 
ceefprt : perfect 
ceeghilnoost : technologies 
ceegiinrv : receiving 
ceegilnst : selecting 
ceeginnrs : screening 
ceeginorz : recognize 
ceeginr : generic 
ceeginst : genetics 
ceegint : genetic 
ceegllo : college 
ceegllos : colleges 
ceehiinrsvz : verzeichnis 
ceehillm : michelle 
ceehiloprt : helicopter 
ceehilsv : vehicles 
ceehilv : vehicle 
ceehinqstu : techniques 
ceehinqtu : technique 
ceehins : chinese 
ceehlloorst : cholesterol 
ceehlortv : chevrolet 
ceehms : scheme 
ceehmss : schemes 
ceehn : hence 
ceehnorssst : screenshots 
ceehnorsst : screenshot 
ceehorrst : rochester 
ceehps : speech 
ceehqu : cheque 
ceehrs : cheers 
ceehrst : chester 
ceeiimopttv : competitive 
ceeiinnorstt : intersection 
ceeiinnstv : incentives 
ceeiinntv : incentive 
ceeiinprst : recipients 
ceeiinprt : recipient 
ceeiiosst : societies 
ceeiiprtuvw : viewpicture 
ceeiirsstu : securities 
ceeillsuvxy : exclusively 
ceeilmnopt : incomplete 
ceeilnosst : selections 
ceeilnost : selection elections 
ceeilnot : election 
ceeilnov : violence 
ceeilns : license silence 
ceeilnss : licenses 
ceeilprsy : precisely 
ceeilps : eclipse 
ceeilsuvx : exclusive 
ceeimmostt : committees 
ceeimmott : committee 
ceeimnoos : economies 
ceeimnrrttu : recruitment 
ceeinnnotv : convenient 
ceeinopprt : perception 
ceeinoprt : reception 
ceeinopstx : exceptions 
ceeinoptx : exception 
ceeinotux : execution 
ceeinrstu : centuries 
ceeinssty : necessity 
ceeinv : venice 
ceeiopprstv : prospective 
ceeioprttv : protective 
ceeip : piece 
ceeipr : recipe pierce 
ceeiprs : recipes precise 
ceeiprt : receipt 
ceeips : pieces 
ceeipss : species 
ceeirssv : services 
ceeirsv : service 
ceejrt : reject 
ceekr : creek 
ceellmopty : completely 
ceellmosu : molecules 
ceelmmnopt : complement 
ceelmopt : complete 
ceelmot : telecom 
ceelmow : welcome 
ceelnnoqstuy : consequently 
ceelnorsu : enclosure 
ceelnort : electron 
ceelnrty : recently 
ceelort : electro 
ceelrstu : lectures 
ceelrsuy : securely 
ceelrtu : lecture 
ceelst : select 
ceelt : elect 
ceelx : excel 
ceemnoprrtu : procurement 
ceemnoptt : competent 
ceemnory : ceremony 
ceemnt : cement 
ceemoorv : overcome 
ceemopt : compete 
ceennortu : encounter 
ceenorrtv : converter 
ceenprs : spencer 
ceenprt : percent 
ceenrs : screen 
ceenrss : screens 
ceenrst : centers centres 
ceenrt : center recent centre 
ceens : scene 
ceenss : scenes 
ceeoprrst : receptors 
ceeoprrt : receptor 
ceeoprsss : processes 
ceeorrssu : resources 
ceeorrstw : worcester 
ceeorrsu : resource 
ceeorrv : recover 
ceeorrvy : recovery 
ceeprst : respect 
ceeprtx : excerpt 
ceepstx : expects 
ceeptx : except expect 
ceersst : secrets 
ceerst : secret 
ceersu : secure rescue 
ceessx : excess 
ceesux : excuse 
ceex : exec 
ceffiilnstuy : sufficiently 
ceffiinstu : sufficient 
ceffio : office 
ceffior : officer 
ceffiors : officers 
ceffios : offices 
cefginoru : configure 
cefh : chef 
cefhi : chief 
cefhnr : french 
cefiinnost : infections 
cefiinnot : infection 
cefiinostu : infectious 
cefiiort : fioricet 
cefipsy : specify 
cefkoorrw : workforce 
cefor : force 
cefors : forces 
cefossu : focuses 
ceghilot : logitech 
ceghlnooty : technology 
cegiiln : ceiling 
cegiilnns : licensing 
cegiinnoort : recognition 
cegiinotv : cognitive 
cegiinrrtu : recruiting 
cegiintx : exciting 
cegilmnopt : completing 
cegilnnosu : counseling 
cegimnopt : competing 
ceginoprss : processing 
ceginoprtt : protecting 
ceginorv : covering 
ceginrrrsttuu : restructuring 
ceglnoo : cologne 
ceglooy : ecology 
ceglosu : glucose 
cegnorss : congress 
cegorry : grocery 
cehhioprrst : christopher 
cehiiinpstz : citizenship 
cehiinrst : christine 
cehiknsst : thickness 
cehiknt : kitchen 
cehil : chile 
cehillmt : mitchell 
cehilm : michel 
cehimnoopr : microphone 
cehimrsty : chemistry 
cehinprtu : pichunter 
cehins : inches 
cehinstty : synthetic 
cehint : ethnic 
cehisstw : switches 
cehist : ethics 
cehkoy : hockey 
cehlost : clothes 
cehlrrsy : chrysler 
cehm : chem 
cehmor : chrome 
cehn : chen 
cehno : cohen 
cehnos : chosen 
cehnot : techno 
ceho : echo 
cehoos : choose 
cehoprs : porsche 
cehos : chose 
cehrry : cherry 
cehrstt : stretch 
cehss : chess 
cehst : chest 
ceht : tech 
cehvy : chevy 
cei : ice 
ceiijnnot : injection 
ceiillptxy : explicitly 
ceiilnppr : principle 
ceiilnpprs : principles 
ceiilnsuv : inclusive 
ceiilops : policies 
ceiilprst : listprice 
ceiilptx : explicit 
ceiimmnoorss : commissioner 
ceiimmnoorsss : commissioners 
ceiimmnostu : communities 
ceiimnoopstt : competitions 
ceiimnooptt : competition 
ceiinnopsst : inspections 
ceiinnopst : inspection 
ceiinopprrst : prescription 
ceiinoprs : precision 
ceiinorrsstt : restrictions 
ceiinorrstt : restriction 
ceiinorrt : criterion 
ceiinov : invoice 
ceiinssstt : scientists 
ceiinsstt : scientist 
ceiinstz : citizens 
ceiinsu : cuisine 
ceiintz : citizen 
ceiist : cities 
ceijnooprt : projection 
ceijstu : justice 
ceiju : juice 
ceikln : nickel 
ceiklostv : livestock 
ceikoo : cookie 
ceikoos : cookies 
ceikrsst : stickers 
ceikrst : sticker 
ceikstt : tickets 
ceiktt : ticket 
ceilmnoopt : completion 
ceilmop : compile 
ceilmopr : compiler 
ceilmoptxy : complexity 
ceilnnosstty : consistently 
ceilno : nicole 
ceilnosux : exclusion 
ceilnp : pencil 
ceilnst : clients 
ceilnt : client 
ceilop : police 
ceilotvy : velocity 
ceim : mice 
ceimmmnostt : commitments 
ceimmmnott : commitment 
ceimmooprs : compromise 
ceimno : income 
ceimnooprss : compression 
ceimnru : numeric 
ceimooprstt : competitors 
ceimoopst : composite 
ceimosstu : customise 
ceimostuz : customize 
ceimox : mexico 
ceimr : crime 
ceimrs : crimes 
ceimrt : metric 
cein : nice 
ceinnnoostv : conventions 
ceinnnootv : convention 
ceinnnot : innocent 
ceinnnott : continent 
ceinnoorsv : conversion 
ceinnoprt : princeton 
ceinnoprty : encryption 
ceinnosstt : consistent 
ceinnostu : continues 
ceinnotu : continue 
ceinntv : vincent 
ceinooprtt : protection 
ceinoprst : inspector 
ceinoprsv : provinces 
ceinoprv : province 
ceinorss : ericsson 
ceinorstu : countries 
ceinosst : sections 
ceinosstttu : constitutes 
ceinost : section notices 
ceinostttu : constitute 
ceinostu : counties 
ceinot : notice 
ceinpr : prince 
ceinprss : princess 
ceins : since 
ceinsst : insects 
ceinst : incest 
ceioprsu : precious 
ceiops : copies 
ceiorru : courier 
ceiort : erotic 
ceiosty : society 
ceiosv : voices 
ceiotx : exotic 
ceiov : voice 
ceip : epic 
ceipr : price 
ceiprs : prices 
ceiprstu : pictures 
ceiprtu : picture 
ceips : spice 
ceir : eric rice 
ceirrstt : restrict 
ceirssu : cruises 
ceirstuy : security 
ceirsu : cruise 
ceit : cite 
ceitw : twice 
ceiv : vice 
cejooprrst : projectors 
cejooprrt : projector 
cejoprst : projects 
cejoprt : project 
cejoy : joyce 
cekkntuy : kentucky 
ceklr : clerk 
cekn : neck 
cekopst : pockets 
cekopt : pocket 
cekort : rocket 
cekost : socket 
cell : cell 
cellnoorrst : controllers 
cellnoorrt : controller 
cellnor : cornell 
cellosy : closely 
cells : cells 
celmopx : complex 
celmssu : muscles 
celmsu : muscle 
celno : clone 
celnoos : console 
celnooss : consoles 
celnosu : counsel 
celnrrtuy : currently 
celnu : uncle 
celo : cole 
celoor : cooler 
celopsu : couples 
celopu : couple 
celors : closer 
celorsu : closure 
celos : close 
celoss : closes 
celosst : closest 
celprstuu : sculpture 
celrsstu : clusters 
celrstu : cluster 
celrstuu : cultures 
celrtuu : culture 
cemmnost : comments 
cemmnot : comment 
cemnnoopst : components 
cemnnoopt : component 
cemnooy : economy 
cemnorssu : consumers 
cemnorsu : consumer 
cemo : come 
cemooprs : composer 
cemoostu : outcomes 
cemootu : outcome 
cemoprstu : computers 
cemoprtu : computer 
cemoptu : compute 
cemorsstu : customers 
cemorstu : customer 
cemos : comes 
cemosstu : costumes 
cemostu : costume 
cemprstu : spectrum 
cemrruy : mercury 
cemry : mercy 
cen : nec 
cennosssu : consensus 
cennost : consent 
cennostt : contents 
cennott : content 
ceno : once 
cenoorrstvy : controversy 
cenorr : corner 
cenorrs : corners 
cenorstu : counters 
cenortu : counter 
cenortv : convert 
cenosstt : contests 
cenostt : contest 
cenottx : context 
cenrrtu : current 
cenrtuy : century 
censsu : census 
censt : cents 
cent : cnet cent 
ceo : ceo eco 
ceoopr : cooper 
ceooprrss : processor 
ceooprrsss : processors 
ceop : cope 
ceoppr : copper 
ceopprsst : prospects 
ceopprst : prospect 
ceoprss : process 
ceoprtt : protect 
ceops : scope 
ceor : core 
ceors : score 
ceorss : scores 
ceorsst : sectors escorts 
ceorssu : courses sources 
ceorst : sector escort 
ceorstuy : courtesy 
ceorsu : source course 
ceorsv : covers 
ceortv : vector 
ceorv : cover 
ceov : cove 
ceps : spec 
cepss : specs 
cepsstu : suspect 
cer : rec 
cerrssttuu : structures 
cerrsttuu : structure 
cerst : crest 
cersuv : curves 
cersw : screw 
ceru : cure 
ceruv : curve 
cerw : crew 
ces : sec 
cet : etc cet 
cetu : cute 
cf : cf fc 
cffil : cliff 
cfggiinnoru : configuring 
cfgiinnnotu : functioning 
cfgiknu : fucking 
cfgino : config 
cfginosu : focusing 
cfiinot : fiction 
cfiklr : flickr 
cfimnor : confirm 
cfimoorst : microsoft 
cfinnoosu : confusion 
cfinnostu : functions 
cfinnotu : function 
cfku : fuck 
cfmoort : comfort 
cfno : conf 
cfosu : focus 
cfr : rfc cfr 
cg : gc cg 
cghiinstw : switching 
cghilnot : clothing 
cghinoos : choosing 
cghioprsty : copyrights 
cghioprty : copyright 
cghiot : gothic 
cghloopsyy : psychology 
cgi : cgi 
cgiikln : licking 
cgiiknp : picking 
cgiilosst : logistics 
cgiimnno : incoming 
cgiinnnotu : continuing 
cgiinnosst : consisting 
cgiinpr : pricing 
cgiinprst : scripting 
cgiklno : locking 
cgiknoo : cooking 
cgiknosst : stockings 
cgiknsu : sucking 
cgillnnoort : controlling 
cgilnnostu : consulting 
cgilnoo : cooling 
cgilnos : closing 
cgilo : logic 
cgilooosy : sociology 
cgimno : coming 
cgimnoptu : computing 
cgimnopu : upcoming 
cginnotu : counting 
cginoorstuu : outsourcing 
cginopy : copying 
cginors : scoring 
cginorss : crossing 
cginttu : cutting 
cgm : gmc 
cgnoo : congo 
ch : ch hc 
chhiw : which 
chi : chi 
chiiorst : historic 
chikt : thick 
chilnooppy : polyphonic 
chimnu : munich 
chin : inch 
chior : choir 
chiosstt : scottish 
chip : chip 
chips : chips 
chipssy : physics 
chipt : pitch 
chir : rich 
chirs : chris 
chirst : christ 
chistw : switch 
chitw : witch 
chklmoost : stockholm 
chkos : shock 
chlnu : lunch 
chloos : school 
chlooss : schools 
chlot : cloth 
chmosstu : cumshots 
chmostu : cumshot 
chmu : much 
chnpu : punch 
cho : cho 
chorssttu : shortcuts 
chorsu : chorus 
chotu : touch 
chsu : such 
ci : ic ci 
ciilnnosu : inclusion 
ciilnos : silicon 
ciilopst : politics 
ciilv : civil 
ciimmnooss : commission 
ciimmnoosss : commissions 
ciimnooopst : composition 
ciimstv : victims 
ciimtv : victim 
ciinnoostttu : constitution 
ciinnorssttu : instructions 
ciinnorsttu : instruction 
ciinnossw : wisconsin 
ciinnottuy : continuity 
ciirss : crisis 
cijnnotu : junction 
cikk : kick 
ciklquy : quickly 
cikn : nick 
cikp : pick 
cikppu : pickup 
cikps : picks 
cikqu : quick 
cikr : rick 
cikrst : tricks 
cikrt : trick 
cikry : ricky 
ciks : sick 
ciksst : sticks 
cikst : stick 
ciksty : sticky 
cillnno : lincoln 
cillnos : collins 
cilmnosstu : columnists 
cilmopsy : olympics 
cilmopy : olympic 
ciln : incl 
cilnnoostuuy : continuously 
cilnnot : clinton 
cilno : colin 
cilopy : policy 
cilp : clip 
cilps : clips 
cilrstty : strictly 
cilrsy : lyrics 
cilry : lyric 
cim : mic 
cimmnostu : communist 
cimmnotuy : community 
cimmot : commit 
cimnnoopstu : consumption 
cimnoorstu : consortium 
cimor : micro 
cims : misc 
cimsu : music 
cin : inc 
cinnoostuu : continuous 
cino : icon coin 
cinooprrtu : corruption 
cinorrssttu : instructors 
cinorrsttu : instructor 
cinos : coins icons sonic 
cinossst : consists 
cinosst : consist 
cinz : zinc 
cio : cio 
ciopst : topics optics 
ciopt : topic 
cior : rico 
ciorsuu : curious 
ciortv : victor 
ciortvy : victory 
ciotx : toxic 
cip : pic pci 
ciprsst : scripts 
ciprst : script 
cips : pics 
ciq : icq 
cir : irc cir 
cirstt : strict 
cirstu : curtis 
cis : sci sic 
ciss : scsi 
cit : ict 
city : city 
civ : vic 
cj : jc cj 
cjv : jvc 
ckkno : knock 
cklnou : unlock 
cklo : lock 
cklos : locks 
cklu : luck 
ckluy : lucky 
ckoo : cook 
ckor : rock cork 
ckors : rocks 
ckory : rocky 
ckoss : socks 
ckosst : stocks 
ckost : stock 
ckrstu : trucks struck 
ckrtu : truck 
ckssu : sucks 
ckstu : stuck 
cksu : suck 
cl : cl lc 
cll : llc 
cllors : scroll 
clmmnooy : commonly 
clmnosu : columns 
clmnou : column 
clmopy : comply 
clnoo : colon 
clnoorst : controls 
clnoort : control 
clnooy : colony 
clnostu : consult 
clo : col loc 
cloo : cool 
cloooprst : protocols 
cloooprt : protocol 
cloor : color 
cloors : colors 
cloorsu : colours 
clooru : colour 
closy : lycos 
clp : plc 
clrt : ctrl 
cltu : cult 
cluy : lucy 
cm : cm mc 
cmmnoo : common 
cmmnoos : commons 
cmmo : comm 
cmo : com 
cmoosw : moscow 
cmop : comp 
cmosstu : customs 
cmostu : custom 
cmp : pmc 
cmr : crm 
cms : cms 
cmu : cum 
cn : nc cn 
cnn : cnn 
cno : con 
cnoopsu : coupons 
cnoopu : coupon 
cnoott : cotton 
cnor : corn 
cnortuy : country 
cnorw : crown 
cnos : cons 
cnost : const 
cnostu : counts tucson 
cnotu : count 
cnotuy : county 
cnst : ntsc 
cnsy : sync 
cntu : cunt 
cny : nyc 
co : co oc 
coops : scoop 
cop : cop 
copr : corp crop proc 
coprs : corps crops 
coprsu : corpus 
copy : copy 
corrsu : cursor 
corss : cross 
corstu : courts 
cortu : court 
cos : soc cos 
cosst : costs 
cost : cost 
costt : scott 
costu : scout 
cot : oct 
cow : cow 
cox : cox 
cp : pc cp 
cpp : ppc 
cprsuy : cyprus 
cps : pcs 
cpsu : cups 
cpt : tcp pct 
cpu : cup cpu upc 
cpv : pvc 
cq : qc 
cr : cr rc 
crs : src 
crsttu : struct 
cruz : cruz 
crv : vcr 
cry : cry 
cs : sc cs 
css : css 
cst : cst 
cstu : cuts 
csu : usc 
csv : cvs 
ct : ct tc 
ctu : cut utc 
cu : cu uc 
cv : cv vc 
cw : wc cw 
cz : cz 
d : d 
dd : dd 
dddeiinv : dividend 
dddeiiv : divided 
ddeeefrr : deferred 
ddeeeilnnnpty : independently 
ddeeeilrv : delivered 
ddeeeimnrt : determined 
ddeeeinnnpt : independent 
ddeeelopv : developed 
ddeeelt : deleted 
ddeeem : deemed 
ddeeen : needed 
ddeeennpt : dependent 
ddeeenrr : rendered 
ddeeentx : extended 
ddeefiiint : identified 
ddeefin : defined 
ddeefinnu : undefined 
ddeefn : defend 
ddeeginnp : depending 
ddeegins : designed 
ddeei : eddie 
ddeein : indeed denied 
ddeeinnt : intended 
ddeeinx : indexed 
ddeeirs : desired 
ddeeirv : derived 
ddeeit : edited 
ddeen : ended 
ddeenoprs : responded 
ddeenors : endorsed 
ddeenp : depend 
ddeenps : depends 
ddeenpssu : suspended 
ddeeorr : ordered 
ddeeorsty : destroyed 
ddeeotv : devoted 
ddeerss : dressed 
ddefiimo : modified 
ddefnou : founded 
ddefnu : funded 
ddeghiiinsstu : distinguished 
ddeginsw : weddings 
ddeginw : wedding 
ddegiu : guided 
ddegnnorruu : underground 
ddego : dodge 
ddehin : hidden 
ddehnrsu : hundreds 
ddehnru : hundred 
ddei : died 
ddeiiv : divide 
ddeilm : middle 
ddeilorww : worldwide 
ddeioprv : provided 
ddeiorrs : disorder 
ddeiorrss : disorders 
ddeir : dried 
ddeistu : studied 
ddelnsuy : suddenly 
ddelort : toddler 
ddenoorstu : understood 
ddenorrsuu : surrounded 
ddensu : sudden 
ddeoppr : dropped 
ddety : teddy 
ddeu : dude 
ddi : did 
ddilo : dildo 
ddilos : dildos 
ddo : odd dod 
ddos : odds 
ddot : todd 
ddr : ddr 
ddsv : dvds 
ddv : dvd 
de : de ed 
dee : dee 
deeeenprrst : represented 
deeefinsv : defensive 
deeefns : defense 
deeefprrr : preferred 
deeefrrr : referred 
deeegirrst : registered 
deeegr : degree 
deeegrs : degrees 
deeeilmmnpt : implemented 
deeeimnrst : determines 
deeeimnrt : determine 
deeeimrs : remedies 
deeeinnnprsttu : superintendent 
deeeinprrtt : interpreted 
deeeinprstux : expenditures 
deeeinprtux : expenditure 
deeeinrstt : interested 
deeeirrtv : retrieved 
deeeirvw : reviewed 
deeeknsw : weekends 
deeeknw : weekend 
deeelmnopstv : developments 
deeelmnoptv : development 
deeeln : needle 
deeeloprsv : developers 
deeeloprv : developer 
deeelt : delete 
deeemnnorst : endorsement 
deeemr : redeem 
deeems : seemed 
deeenprst : presented 
deeenrt : entered 
deeepr : deeper 
deeeprssx : expressed 
deeeqrstu : requested 
deeerrsv : reserved 
deeersv : deserve 
deef : feed 
deeffhils : sheffield 
deeffilnrty : differently 
deeffinrt : different 
deeffor : offered 
deeffrsu : suffered 
deefgin : feeding 
deefiiinrt : identifier 
deefiiinst : identifies 
deefiilnty : definitely 
deefiirv : verified 
deefin : define 
deefinr : refined 
deefins : defines 
deefmoprr : performed 
deefmor : freedom 
deefrsu : refused 
deefs : feeds 
deeg : edge 
deeggsstu : suggested 
deeghitw : weighted 
deegiilnrv : delivering 
deegiilnsu : guidelines 
deegiimnnrt : determining 
deegiinnrst : ingredients 
deegilnopv : developing 
deeginnrr : rendering 
deeginntx : extending 
deeginrs : designer 
deeginrss : designers 
deegklmnoorstw : knowledgestorm 
deegklnow : knowledge 
deegln : legend 
deeglns : legends 
deeglp : pledge 
deegnr : gender 
deegs : edges 
deehhprs : shepherd 
deehiinrt : inherited 
deehlp : helped 
deehnnors : henderson 
deeiirrsv : riverside 
deeilmn : medline 
deeilnrssw : wilderness 
deeilntt : entitled 
deeilpr : replied 
deeilrsv : delivers 
deeilrv : deliver 
deeilrvy : delivery 
deeils : diesel 
deeimnnot : mentioned 
deeimnrr : reminder 
deeimprss : impressed 
deeimprtt : permitted 
deeinoprss : depression 
deeinort : oriented 
deeinprst : president 
deeinrsst : residents 
deeinrst : resident inserted 
deeinsx : indexes 
deeintv : evident 
deeiops : episode 
deeiopss : episodes 
deeippqu : equipped 
deeiprx : expired 
deeipst : despite 
deeiqrru : required 
deeirrt : retired 
deeirs : desire 
deeirsv : revised diverse 
deeistx : existed 
deeivw : viewed 
deejnoy : enjoyed 
deeknny : kennedy 
deekr : derek 
deellnor : enrolled 
deellry : elderly 
deelmnopty : deployment 
deelmopy : employed 
deelnr : lender 
deelnrs : lenders 
deelnss : endless 
deelopsv : develops 
deelopv : develop 
deelorsv : resolved 
deelpy : deeply 
deelr : elder 
deelrstu : resulted 
deels : leeds 
deelstt : settled 
deelux : deluxe 
deelv : devel 
deemnorstu : tremendous 
deemorv : removed 
deemry : remedy 
deen : need eden 
deennoprsst : respondents 
deennoprst : respondent 
deenop : opened 
deenrr : render 
deenrrtu : returned 
deenrs : sender 
deenrt : tender 
deenrv : denver 
deens : needs dense 
deenst : nested 
deenstx : extends 
deensw : sweden 
deentx : extend 
deeoprrt : reported 
deeoprw : powered 
deeopsx : exposed 
deeorrst : restored 
deep : deep 
deeprss : pressed 
deeps : speed 
deepss : speeds 
deer : reed deer 
deersss : dresses 
deerst : desert 
deersv : served 
deerv : verde 
dees : seed 
deess : seeds 
deestt : tested 
deew : weed 
deey : eyed 
def : def fed 
deffir : differ 
deffstu : stuffed 
defgiiinnty : identifying 
defgiilnprs : springfield 
defgiilnrr : girlfriend 
defgiinn : defining 
defgir : fridge 
defgiru : figured 
defhiinprs : friendship 
defhiins : finished 
defhinrsu : furnished 
defiiilmps : simplified 
defiiinnost : definitions 
defiiinnot : definition 
defiillw : wildlife 
defiinot : notified 
defiinty : identify 
defiinu : unified 
defil : field filed 
defill : filled 
defilnry : friendly 
defils : fields 
defimnor : informed 
defin : endif 
definr : friend finder 
definrs : friends 
defir : fired 
defitt : fitted 
defix : fixed 
deflloow : followed 
deflnoruw : wonderful 
deflor : folder 
deflors : folders 
defmor : formed 
defnoru : founder 
defnru : refund 
defr : fred 
degghhhiilt : highlighted 
deggiinns : designing 
degglo : logged 
deghilt : delight 
deghlmoooty : methodology 
deghnory : hydrogen 
degiinnosu : indigenous 
degiint : editing 
degillmno : modelling 
degilmno : modeling 
degilnn : lending 
degilnnruy : underlying 
degilnotu : longitude 
degilnw : welding 
deginn : ending 
deginnoprs : responding 
deginnorw : wondering 
deginnp : pending 
deginnps : spending 
deginns : sending 
deginnsu : unsigned 
deginor : ignored 
deginorr : ordering 
deginrss : dressing 
degins : design signed 
deginss : designs 
degio : diego 
degir : ridge 
degist : digest 
degisu : guides 
degiu : guide 
degjmntu : judgment 
degjsu : judges 
degju : judge 
deglno : golden 
deglo : lodge 
dehhloossu : households 
dehhloosu : household 
dehhlorst : threshold 
dehi : hide 
dehiiklloo : likelihood 
dehil : delhi 
dehilops : polished 
dehilossw : slideshow 
dehils : shield 
dehipps : shipped 
dehir : hired 
dehiss : dishes 
dehissw : swedish 
dehl : held 
dehlmo : holdem 
dehlor : holder 
dehlors : holders 
dehlorsu : shoulder 
dehmost : methods 
dehmot : method 
dehnrtu : thunder 
dehop : hoped 
dehor : rhode 
dehost : hosted 
dehosw : showed 
dehpsu : pushed 
dehpt : depth 
dehs : shed 
dei : die ide 
deiilmntu : unlimited 
deiilmp : implied 
deiilmt : limited 
deiimnnos : dimension 
deiimnnoss : dimensions 
deiin : indie 
deiinost : editions 
deiinot : edition 
deiinprs : inspired 
deiinrs : insider 
deiinrsstu : industries 
deiins : inside 
deiintty : identity 
deiintv : invited 
deiinv : divine 
deiirstvy : diversity 
deiistv : visited 
deijno : joined 
deijnru : injured 
deikl : liked 
deikll : killed 
deiklls : skilled 
deikln : linked 
deikny : kidney 
deil : idle 
deiln : lined 
deilnotu : outlined 
deilnovv : involved 
deilnttu : untitled 
deilors : soldier 
deilorss : soldiers 
deilppsu : supplied 
deils : slide 
deilss : slides 
deilst : listed 
deilsy : yields 
deiltt : titled 
deilv : lived devil 
deilwy : widely 
deily : yield 
deimmu : medium 
deimnoort : monitored 
deimnr : remind 
deimoprs : promised 
deimoprt : imported 
deimoprv : improved 
deimops : imposed 
deimss : missed 
deimstw : midwest 
deimx : mixed 
deinnnot : nintendo 
deinnr : dinner 
deinns : dennis 
deinnt : intend 
deinopt : pointed 
deinprt : printed 
deinrsu : insured 
deinrv : driven 
deinsstt : dentists 
deinsty : density destiny 
deinsy : disney 
deintu : united 
deinx : index 
deiopr : period 
deioprrsv : providers 
deioprrv : provider 
deioprs : periods 
deioprsv : provides 
deioprv : provide 
deiopsst : deposits 
deiopst : deposit 
deiorrw : worried 
deiorst : editors 
deiort : editor 
deiortt : detroit 
deiostu : outside 
deiosv : videos 
deiov : video 
deiox : oxide 
deipr : pride 
deiprrssu : surprised 
deiprs : spider 
deipsstu : disputes 
deipstu : dispute 
deir : ride reid 
deirr : rider 
deirrs : riders 
deirrsv : drivers 
deirrv : driver 
deirs : rides 
deirsv : drives 
deirt : tried tired 
deirv : drive 
deirw : weird wired wider 
deis : side dies 
deiss : sides 
deisstu : studies 
deissu : issued 
deisttw : twisted 
deistu : duties suited 
deisz : sized 
deit : edit diet tied tide 
deiv : dive 
deiw : wide 
dek : kde 
dekloo : looked 
dekopsst : desktops 
dekopst : desktop 
dekorswy : keywords 
dekorw : worked 
dekorwy : keyword 
deks : desk 
deku : duke 
del : led del 
dell : dell 
dellor : rolled 
dellpu : pulled 
delmo : model 
delmos : models 
delmosu : modules 
delmou : module 
delnorsy : reynolds 
delor : older 
delorswx : worldsex 
delost : oldest 
delosv : solved 
delov : loved 
delru : ruled 
dem : med dem 
demmo : modem 
demmos : modems 
demnnoot : edmonton 
demnor : modern 
demnorsy : syndrome 
demnotu : mounted 
demo : mode demo dome 
demooprt : promoted 
demos : modes 
demov : moved 
demrru : murder 
den : end den 
deno : done node 
denooprss : sponsored 
denoow : wooden 
denoprs : respond 
denorsv : vendors 
denorv : vendor 
denorw : wonder 
denos : nodes 
denosz : dozens 
denot : noted 
denov : devon 
denow : owned 
denoz : dozen 
denps : spend 
denrst : trends 
denrt : trend 
denrtu : turned 
denru : under 
dens : send ends 
denss : sends 
denssttu : students 
densttu : student 
densyy : sydney 
dent : tend 
dentz : zdnet 
denu : nude 
denwy : wendy 
deny : deny 
deo : doe 
deoopprs : proposed 
deoopps : opposed 
deooppsstt : postposted 
deopprstu : supported 
deoppssu : supposed 
deoppst : stopped 
deoprrssw : wordpress 
deoprv : proved 
deoprw : powder 
deopst : posted 
deopt : depot 
deoqtu : quoted 
deorr : order 
deorrs : orders 
deorst : sorted stored 
deorsty : destroy 
deorv : dover drove 
deos : does dose 
deotv : voted 
dept : dept 
deptuy : deputy 
der : red der 
derry : dryer 
derss : dress 
dersttu : trusted 
derw : drew 
des : des eds 
desu : used 
det : edt ted 
deu : due 
dev : dev 
dew : wed 
df : df fd 
dffi : diff 
dffis : diffs 
dfgiinn : finding 
dfgiinns : findings 
dfgilno : folding 
dfginnu : funding 
dfilu : fluid 
dfimoy : modify 
dfin : find 
dfins : finds 
dflo : fold 
dfloo : flood 
dfloy : floyd 
dfnou : found 
dfnsu : funds 
dfnu : fund 
dfoo : food 
dfoorx : oxford 
dfoos : foods 
dfor : ford 
dfp : pdf 
dfw : fwd 
dg : dg gd 
dggilno : lodging 
dghiimnt : midnight 
dghilno : holding 
dghilnos : holdings 
dgi : dig 
dgiiknnr : drinking 
dgiillnr : drilling 
dgiinn : dining 
dgiinoprv : providing 
dgiinr : riding 
dgiinrv : driving 
dgiinv : diving 
dgiit : digit 
dgikmno : kingdom 
dgilu : guild 
dgims : msgid 
dginnorrsuu : surrounding 
dgino : doing 
dginru : during 
dginstuy : studying 
dginy : dying 
dgir : grid 
dglo : gold 
dgnoor : gordon 
dgnorsu : grounds 
dgnoru : ground 
dgo : god dog 
dgoo : good 
dgoos : goods 
dgos : dogs gods 
dgou : doug 
dgp : gdp 
dgrsu : drugs 
dgru : drug 
dh : hd dh 
dhiimtuy : humidity 
dhinu : hindu 
dhirt : third 
dhis : dish 
dhitw : width 
dhllooowy : hollywood 
dhlo : hold 
dhlos : holds 
dhlosu : should 
dhnosu : hudson 
dhoo : hood 
dhp : phd 
dhtv : hdtv 
di : id di 
diiinoopsst : disposition 
diiinossv : divisions 
diiinosv : division 
diilqu : liquid 
diim : midi 
dik : kid 
dikn : kind 
diknr : drink 
diknrs : drinks 
dikns : kinds 
diks : kids disk 
dikss : disks 
dil : lid 
dillr : drill 
dilm : mild 
dilo : idol 
dilos : solid 
dilw : wild 
dim : mid dim 
dimn : mind 
dimns : minds 
dimosu : sodium 
dimosw : wisdom 
dimp : pmid 
din : ind 
dinoor : indoor 
dinorsw : windsor 
dinosww : windows 
dinoww : window 
dinrstuy : industry 
dinstu : nudist 
dinsw : winds 
dintuy : nudity 
dinw : wind 
diop : ipod 
diosstu : studios 
diostu : studio 
diov : void 
dip : dpi dip 
dipstu : stupid 
dir : dir rid 
dirt : dirt 
dirty : dirty 
dis : dis ids 
dist : dist 
disv : vids 
diu : dui 
div : vid div 
divx : divx 
diy : diy 
dj : dj jd 
djuy : judy 
dk : dk 
dknru : drunk 
dl : dl ld 
dllo : doll 
dllos : dolls 
dlloy : lloyd 
dlmo : mold 
dlnnoo : london 
dlo : old 
dlopruy : proudly 
dlor : lord 
dlorsw : worlds 
dlorw : world 
dlos : sold 
dlot : told 
dlou : loud 
dlouw : would 
dlq : qld 
dls : dsl 
dlt : ltd 
dm : md dm 
dmo : mod dom 
dmoo : mood doom 
dmos : mods 
dmpu : dump 
dmrsu : drums 
dmru : drum 
dmu : mud 
dn : nd 
dnnootww : downtown 
dno : don 
dnoor : donor 
dnoors : donors 
dnop : pond 
dnopsu : pounds 
dnopu : pound 
dnorrsuu : surround 
dnorsu : rounds 
dnoru : round 
dnossu : sounds 
dnosu : sound 
dnot : dont 
dnou : undo 
dnouw : wound 
dnow : down 
dns : dns 
dnu : und 
do : do 
dooorstu : outdoors 
dooortu : outdoor 
door : door 
doors : doors 
doost : stood 
doosw : woods 
doow : wood 
dop : pod 
dopr : drop 
doprs : drops 
dopru : proud 
dor : rod 
dorsw : words sword 
dorw : word 
dos : dos 
dot : dot 
dou : duo 
dow : dow 
dp : pd dp 
dpt : pdt 
dr : dr rd 
dry : dry 
ds : sd ds 
dst : std dts 
dstu : dust stud 
dstuy : study 
dsu : usd 
dt : td dt 
dtuy : duty 
du : du 
dv : dv 
dx : dx 
e : e 
ee : ee 
eeeehlnrsstv : nevertheless 
eeeehlrsw : elsewhere 
eeeehrrvwy : everywhere 
eeeennprrrstu : entrepreneurs 
eeeennprrrtu : entrepreneur 
eeeennsst : tennessee 
eeefgrsu : refugees 
eeefhorrt : therefore 
eeefrz : freeze 
eeeggiinnnr : engineering 
eeeghnorsu : greenhouse 
eeeginnprrst : representing 
eeeginnr : engineer 
eeeginnrs : engineers 
eeegmnrss : messenger 
eeegnr : greene 
eeegnrv : revenge 
eeegnu : eugene 
eeehimnnprt : phentermine 
eeehlmsstv : themselves 
eeehlnopt : telephone 
eeehmorst : threesome 
eeehmorsw : somewhere 
eeehnrtt : ethernet 
eeehnrvw : whenever 
eeehrrvw : wherever 
eeei : ieee 
eeeiinnpsvx : inexpensive 
eeeiipqrrstu : prerequisite 
eeeimnprstx : experiments 
eeeimnprtx : experiment 
eeeimnqrrstu : requirements 
eeeimnqrrtu : requirement 
eeeimnrrtt : retirement 
eeeimns : enemies 
eeeimprr : premiere 
eeeinprrsst : enterprises 
eeeinprrst : enterprise 
eeeinpsvx : expensive 
eeeinstvx : extensive 
eeeiprstx : expertise 
eeeirrtv : retrieve 
eeeirrvw : reviewer 
eeejllrwy : jewellery 
eeekrs : seeker 
eeekrss : seekers 
eeelloprrsw : powerseller 
eeellrrs : reseller 
eeelmnst : elements 
eeelmnsttt : settlement 
eeelmnt : element 
eeelmopsy : employees 
eeelmopy : employee 
eeelmrtxy : extremely 
eeelnopv : envelope 
eeelnrssttw : newsletters 
eeelnrsttw : newsletter 
eeelnv : eleven 
eeelsv : sleeve 
eeemrsst : semester 
eeemrtx : extreme 
eeenorvy : everyone 
eeenprrsst : represents 
eeenprrst : represent 
eeenpssx : expenses 
eeenpsx : expense 
eeenrsuv : revenues 
eeenruv : revenue 
eeeprrsv : preserve 
eeerrssv : reserves 
eeerrsv : reserve reverse 
eeersv : severe 
eef : fee 
eeffinosv : offensive 
eeffint : fifteen 
eeffjnors : jefferson 
eeffjry : jeffrey 
eeffnos : offense 
eefgiimnnnrt : infringement 
eefgiln : feeling 
eefgilns : feelings 
eefginrrr : referring 
eefhiirss : fisheries 
eefhlrs : herself 
eefhmorrrtu : furthermore 
eefhort : thereof 
eefhrrs : refresh 
eefiilmt : lifetime 
eefiirrw : firewire 
eefijnnr : jennifer 
eefillsty : lifestyle 
eefilr : relief 
eefinr : refine 
eefl : feel 
eeflnqrtuy : frequently 
eeflry : freely 
eefls : feels 
eeflt : fleet 
eefmoprrr : performer 
eefmpru : perfume 
eefnqrtu : frequent 
eeforrv : forever 
eefprr : prefer 
eefprrs : prefers 
eefr : free reef 
eefrr : refer 
eefrrs : refers 
eefrsu : refuse 
eefrv : fever 
eefrw : fewer 
eefs : fees 
eeft : feet 
eegghinnnrstt : strengthening 
eeggimnr : emerging 
eegginrst : greetings 
eegginrt : greeting 
eeggor : george 
eeghinrtvy : everything 
eeghiny : hygiene 
eeghnnrstt : strengthen 
eeghortt : together 
eegiillnntt : intelligent 
eegiilmmnnpt : implementing 
eegiilnr : lingerie 
eegiilprsv : privileges 
eegiilprv : privilege 
eegiinnrstt : interesting 
eegiinrvw : reviewing 
eegiknp : keeping 
eegikns : seeking 
eegilnps : sleeping 
eegimnst : meetings 
eegimnt : meeting 
eegimr : regime 
eeginn : engine 
eeginnprst : presenting 
eeginnprtv : preventing 
eeginnrt : entering 
eeginns : engines 
eeginnu : genuine 
eeginnv : evening 
eeginorrss : regression 
eeginp : peeing 
eeginqrstu : requesting 
eeginrst : steering 
eeginrt : integer 
eegins : seeing 
eeginss : genesis 
eegioprrssv : progressive 
eegirrst : register 
eegk : geek 
eegkr : greek 
eeglnt : gentle 
eegmnnorstv : governments 
eegmnnortv : government 
eegmno : genome 
eegmnsst : segments 
eegmnst : segment 
eegmorty : geometry 
eegmr : merge 
eegmrr : merger 
eegn : gene 
eegnorsu : generous 
eegnr : green genre 
eegnrs : genres 
eegnry : energy 
eegns : genes 
eegoprstuu : portuguese 
eehhrtw : whether 
eehinr : herein 
eehinrt : neither 
eehiorst : theories 
eehiorstw : otherwise 
eehiossuvw : housewives 
eehirt : either 
eehknnt : kenneth 
eehl : heel 
eehlmoss : homeless 
eehlmt : helmet 
eehln : helen 
eehlnopty : telephony 
eehlrst : shelter 
eehlsw : wheels 
eehlttw : hewlett 
eehlw : wheel 
eehmnnnoop : phenomenon 
eehmort : theorem 
eehmst : themes 
eehmt : theme 
eehnorw : nowhere 
eehnpst : stephen 
eehnstv : seventh 
eehors : heroes 
eehorvw : however 
eehprs : sphere 
eehps : sheep 
eehr : here 
eehrs : sheer 
eehrt : there three 
eehrw : where 
eehsst : sheets 
eehst : these sheet 
eeht : thee 
eehtt : teeth 
eeiiinrsstuv : universities 
eeiiklsw : likewise 
eeiilmnt : timeline 
eeiilnosstv : televisions 
eeiilnostv : television 
eeiilnpp : pipeline 
eeiimprssv : impressive 
eeiinnnorsttv : interventions 
eeiinnnorttv : intervention 
eeiinnstv : intensive 
eeiinqrsu : enquiries 
eeiinrstvw : interviews 
eeiinrtvw : interview 
eeiinsstv : sensitive 
eeiinstt : entities 
eeiiorrrstt : territories 
eeijlnuv : juvenile 
eeiklmorst : kilometers 
eeills : leslie 
eeilmmnpt : implement 
eeilmnnotvv : involvement 
eeilnrty : entirely 
eeilprs : replies 
eeilrssw : wireless 
eeilrsu : leisure 
eeilsttx : textiles 
eeilsvx : livesex 
eeilt : elite 
eeilttx : textile 
eeimmn : eminem 
eeimmnoprstv : improvements 
eeimmnoprtv : improvement 
eeimmors : memories 
eeimmosst : sometimes 
eeimnnnorstv : environments 
eeimnnnortv : environment 
eeimnnssttv : investments 
eeimnnsttv : investment 
eeimnoptx : exemption 
eeimnpqtu : equipment 
eeimnrssttw : westminster 
eeimnss : siemens 
eeimpr : empire 
eeimprr : premier 
eeimprss : premises 
eeinnoprtv : prevention 
eeinnortt : retention 
eeinnosstx : extensions 
eeinnostx : extension 
eeinnrtt : internet 
eeinnst : intense 
eeinopr : pioneer 
eeinoprsssx : expressions 
eeinoprssx : expression 
eeinprsstt : persistent 
eeinrsstt : interests 
eeinrst : entries 
eeinrstt : interest 
eeinrsuv : universe 
eeinrt : entire 
eeinssstw : witnesses 
eeiopprrst : properties 
eeiorrrsv : reservoir 
eeiorrtx : exterior 
eeiorvvw : overview 
eeiprr : pierre 
eeiprsvw : previews 
eeiprsx : expires 
eeiprvw : preview 
eeiptt : petite 
eeiqrrsu : requires 
eeiqrru : require 
eeiqrsu : queries 
eeirss : series 
eeirsvw : reviews viewers 
eeirvw : review viewer 
eejlrwy : jewelry 
eejlw : jewel 
eejmry : jeremy 
eejp : jeep 
eejrsy : jersey 
eejss : jesse 
eeklnr : kernel 
eeklwy : weekly 
eekn : knee keen 
eekp : keep 
eekps : keeps 
eeks : seek 
eekss : seeks 
eeksw : weeks 
eekw : week 
eel : lee 
eellmnnort : enrollment 
eelln : ellen 
eellnssw : wellness 
eellrs : seller 
eellrss : sellers 
eellsv : levels 
eellv : level 
eelmmnnoptuy : unemployment 
eelmmnopty : employment 
eelmnppsstu : supplements 
eelmnppstu : supplement 
eelmoprsy : employers 
eelmoprtu : petroleum 
eelmopry : employer 
eelmpt : temple 
eelmry : merely 
eelnnoprs : personnel 
eelno : leone 
eelnorstuv : volunteers 
eelnortuv : volunteer 
eelnprsty : presently 
eelnss : lenses 
eelntx : nextel 
eelopp : people 
eelopps : peoples 
eeloprrx : explorer 
eeloprsty : polyester 
eeloprx : explore 
eelorssuv : ourselves 
eelorsv : resolve 
eelorttu : roulette 
eelps : sleep 
eelpss : sleeps 
eelr : reel 
eelrss : lesser 
eelrstt : letters 
eelrtt : letter 
eels : else 
eelsssv : vessels 
eelssv : vessel 
eelst : steel 
eelstt : settle 
eelswy : wesley 
eeltvv : velvet 
eeltvw : twelve 
eemmnostv : movements 
eemmnotv : movement 
eemnoos : someone 
eemny : enemy yemen 
eemnyz : enzyme 
eemoorrv : moreover 
eemoprr : emperor 
eemorsst : somerset 
eemort : remote 
eemorv : remove 
eemprsu : supreme 
eemptu : meetup 
eemptx : exempt 
eemr : mere 
eemrssu : resumes 
eemrst : meters metres 
eemrsu : resume 
eemrt : meter 
eemry : meyer 
eems : seem 
eemss : seems 
eemst : meets 
eemt : meet 
eenoprss : response 
eenoprsss : responses 
eenoprst : peterson 
eenprsst : presents 
eenprst : present 
eenprtv : prevent 
eenqsu : queens 
eenqu : queen 
eenrssu : ensures 
eenrst : enters 
eenrstuv : ventures 
eenrstw : western 
eenrsu : ensure 
eenrt : enter 
eenrtuv : venture 
eenrv : never nerve 
eenrw : newer renew 
eens : seen 
eenss : sense 
eensstv : stevens 
eenst : teens 
eenstv : events steven 
eenstw : newest 
eensuv : venues 
eensv : seven 
eent : teen 
eenttx : extent 
eentv : event 
eenuv : venue 
eenv : even 
eeoprrrst : reporters 
eeoprrrt : reporter 
eeoprsux : exposure 
eeopru : europe 
eeorrst : restore 
eeorst : stereo 
eep : pee 
eepppr : pepper 
eepr : peer 
eeprrssu : pressure 
eeprs : peers 
eeprssx : express 
eeprstx : experts 
eeprt : peter 
eeprtx : expert 
eept : pete 
eeqrsstu : requests 
eeqrstu : request 
eequu : queue 
eerrssv : servers 
eerrstu : reuters 
eerrsv : server 
eersstt : streets 
eerssttu : trustees 
eerssv : serves 
eerst : trees reset 
eerstt : street 
eersttu : trustee 
eersv : serve verse 
eert : tree 
eerttux : texture 
eertvx : vertex 
eerv : ever 
eervy : every 
eerw : were 
ees : see 
eess : sees 
eessx : essex 
eestv : steve 
eestw : sweet 
eesy : eyes 
eet : tee 
eev : eve 
eey : eye 
ef : fe ef 
effginor : offering 
effginors : offerings 
effginrsu : suffering 
effhirs : sheriff 
effhoors : offshore 
effilno : offline 
effiorx : firefox 
effj : jeff 
effo : feof 
effor : offer 
effors : offers 
efforst : efforts 
effort : effort 
effost : offset 
effrsu : suffer 
efggiinnr : fingering 
efghiilnt : nightlife 
efghirst : fighters 
efghirt : freight fighter 
efgiilnrt : filtering 
efgimnoprr : performing 
efginor : foreign 
efginr : finger 
efginrs : fingers 
efgirsu : figures 
efgiru : figure 
efgnoortt : forgotten 
efgor : forge 
efgort : forget 
efhillopsw : fellowship 
efhilmnrtu : milfhunter 
efhilms : himself 
efhirs : fisher 
efhist : fetish 
efhllopuy : hopefully 
efhllpu : helpful 
efhls : shelf flesh 
efhr : href 
efhrrtu : further 
efhrs : fresh 
efhtt : theft 
efiiinnt : infinite 
efiint : finite 
efikn : knife 
efil : life file 
efilm : filme 
efilopr : profile 
efiloprs : profiles 
efilrst : filters 
efilrt : filter 
efils : files 
efilst : itself 
efin : fine 
efinooprss : profession 
efinorrt : frontier 
efinrrtuu : furniture 
efinsst : fitness 
efinst : finest 
efiprx : prefix 
efir : fire 
efirs : fires 
efirstux : fixtures 
efirvy : verify 
efisx : fixes 
efiv : five 
efiw : wife 
efjlost : jelsoft 
efll : fell 
efllow : fellow 
eflmorry : formerly 
eflmsy : myself 
eflopruw : powerful 
eflorsuy : yourself 
eflorsw : flowers 
eflorw : flower 
eflry : flyer 
efls : self 
eflsuu : useful 
eflt : left felt 
eflu : fuel 
eflx : flex 
efmoprr : perform 
efmoprrs : performs 
efmorr : former reform 
efmorrs : reforms 
efnortu : fortune 
efnorz : frozen 
efnot : often 
efooprrss : professor 
eforrsty : forestry 
eforsst : forests 
eforst : forest foster 
efr : ref 
efrry : ferry 
efrstuu : futures 
efrtuu : future 
efw : few 
eg : eg ge 
egg : egg 
eggginsstu : suggesting 
egghhiilttw : lightweight 
egginnorv : governing 
egginossstu : suggestions 
egginosstu : suggestion 
eggintt : getting 
eggirrt : trigger 
eggloo : google 
egglooy : geology 
egglrstu : struggle 
eggoorsu : gorgeous 
eggorry : gregory 
eggr : greg 
eggs : eggs 
eggssstu : suggests 
eggsstu : suggest 
eghhir : higher 
eghhist : highest heights 
eghhit : height 
eghhsu : hughes 
eghilnp : helping 
eghilns : english 
eghilrt : lighter 
eghimnost : something 
eghinortv : overnight 
eghistw : weights 
eghit : eight 
eghitw : weight 
eghlnt : length 
eghlooty : theology 
eghnou : enough 
eghnrsstt : strengths 
eghnrstt : strength 
eghnru : hunger 
eghu : huge 
egiilnnst : listening 
egiilnor : religion 
egiilnors : religions 
egiilorsu : religious 
egiinnstv : investing 
egiinqrru : requiring 
egiinrtty : integrity 
egiinstx : existing 
egiinvw : viewing 
egijnnoy : enjoying 
egiknnortw : networking 
egillnnotw : wellington 
egillnps : spelling 
egillns : selling 
egillnt : telling 
egilmnoorty : terminology 
egilnnotx : lexington 
egilnoprx : exploring 
egilnrst : sterling 
egilnrstu : resulting 
egilnrstw : wrestling 
egilnry : relying 
egilns : single 
egilnss : singles 
egilntt : letting 
egimnorv : removing 
eginnop : opening 
eginnops : openings 
eginnorst : ringtones 
eginnort : ringtone nitrogen 
eginnpu : penguin 
eginnrrtu : returning 
eginnrsu : ensuring 
eginoprrt : reporting 
eginor : region ignore 
eginors : regions 
eginprrs : springer 
eginprss : pressing 
eginr : niger 
eginrs : singer 
eginrssw : swingers 
eginrsv : serving 
eginsstt : settings 
eginstt : testing setting 
eginsu : genius 
eginsw : sewing 
eginv : given 
egirrsty : registry 
egirst : tigers 
egirt : tiger 
egisv : gives 
egiv : give 
egjlnu : jungle 
egjp : jpeg 
egkrru : kruger 
egl : leg gel 
egln : glen 
eglnn : glenn 
eglnor : longer 
eglnost : longest 
eglnou : lounge 
eglnty : gently 
eglops : gospel 
eglosv : gloves 
egls : legs 
egm : gem 
egmmnoorty : montgomery 
egmno : gnome 
egmortu : gourmet 
egmp : mpeg 
egmps : mpegs 
egn : eng gen 
egno : gone 
egnoor : oregon 
egnoorrv : governor 
egnorrst : stronger 
egnorssu : surgeons 
egnorsu : surgeon 
egnoruy : younger 
egnott : gotten 
egnotu : tongue 
egnoxy : oxygen 
egnrtu : urgent 
ego : geo 
egoorv : groove 
egoprrss : progress 
egor : gore 
egorr : roger 
egorrs : rogers 
egoru : rouge 
egorv : grove 
egos : goes 
egpty : egypt 
egr : reg 
egrrsuy : surgery 
egrsu : surge 
egru : urge 
egrw : grew 
egry : grey 
egsstu : guests 
egssu : guess 
egst : gets 
egstu : guest 
egt : get 
eh : he eh 
ehhiopssty : hypothesis 
ehhntu : thehun 
ehiiilnppps : philippines 
ehiinnprst : internship 
ehijsw : jewish 
ehikorrsy : yorkshire 
ehikt : keith 
ehillrrt : thriller 
ehilw : while 
ehimmps : memphis 
ehimnnpstu : punishment 
ehimnpsst : shipments 
ehimnpst : shipment 
ehimosstw : showtimes 
ehinnssu : sunshine 
ehinoprsw : ownership 
ehinopx : phoenix 
ehins : shine 
ehinsssty : synthesis 
ehir : hire 
ehirt : their 
ehisst : thesis 
ehissw : wishes 
ehitw : white 
ehjops : joseph 
ehkmoorw : homework 
ehll : hell 
ehllo : hello 
ehlls : shell 
ehlmos : holmes 
ehlo : hole 
ehlos : holes 
ehlosst : hostels 
ehlost : hotels hostel 
ehlot : hotel 
ehlow : whole 
ehlp : help 
ehlps : helps 
ehlrtu : luther 
ehlsttu : shuttle 
ehlsw : welsh 
ehmnoor : hormone 
ehmnootw : hometown 
ehmo : home 
ehmoosw : somehow 
ehmorst : mothers 
ehmort : mother 
ehmos : homes 
ehms : mesh 
ehmt : them 
ehnnorrt : northern 
ehnop : phone 
ehnops : phones 
ehnorsttw : northwest 
ehnorstu : southern 
ehnost : honest 
ehnoy : honey 
ehnrtu : hunter 
ehnry : henry 
ehnt : then 
ehnw : when 
ehop : hope 
ehopprs : shopper 
ehopprss : shoppers 
ehopprt : prophet 
ehops : hopes 
ehor : hero 
ehorrst : shorter 
ehors : horse shore 
ehorss : horses 
ehorssw : showers 
ehorst : others 
ehorsw : shower 
ehort : other 
ehorty : theory 
ehorw : whore 
ehos : shoe hose 
ehoss : shoes 
ehossttuw : southwest 
ehossu : houses 
ehost : those 
ehosttt : hottest 
ehosu : house 
ehosw : whose 
ehprt : perth 
ehr : her 
ehs : she 
eht : the 
ehty : they 
ehy : hey 
ei : ie 
eiiilsttu : utilities 
eiiimmnz : minimize 
eiiimnrsst : ministries 
eiiinqrsu : inquiries 
eiiinssttvy : sensitivity 
eiiioprrst : priorities 
eiijnrsu : injuries 
eiilllosuv : louisville 
eiillmmnnu : millennium 
eiilmnossu : limousines 
eiilmps : implies 
eiilmss : smilies missile 
eiilnn : inline 
eiiltuz : utilize 
eiimnoprss : permission impression 
eiimnoprsss : permissions 
eiimnoss : emission 
eiimnosss : emissions 
eiimnrsst : ministers 
eiimnrst : minister 
eiimnrt : interim 
eiimoptz : optimize 
eiinnnott : intention 
eiinnnotv : invention 
eiinnops : epinions 
eiinnorst : insertion 
eiinnstty : intensity 
eiinoopprsttu : opportunities 
eiinoprssuv : supervision 
eiinoptt : petition 
eiinorrt : interior 
eiinorssv : revisions 
eiinorsv : revision 
eiinqru : inquire 
eiinrstuvy : university 
eiinsstttu : institutes 
eiinstttu : institute 
eiintv : invite 
eiiopstv : positive 
eijknt : inkjet 
eijlu : julie 
eikl : like 
eikllnuy : unlikely 
eikllr : killer 
eiklly : likely 
eikln : klein 
eiklnu : unlike 
eikls : likes 
eikm : mike 
eikn : nike 
eiknsv : knives 
eiknv : kevin 
eikp : pike 
eikr : erik 
eikrsst : strikes 
eikrst : strike 
eil : lie 
eillmptu : multiple 
eillmr : miller 
eillnss : illness 
eillooprv : liverpool 
eillott : elliott 
eills : ellis 
eilltt : little 
eilm : mile lime 
eilmps : simple 
eilms : miles smile 
eilmty : timely 
eilmy : emily 
eiln : line neil 
eilnno : online 
eilnoopsx : explosion 
eilnoorsstu : resolutions 
eilnoorstu : resolution 
eilnoortuv : revolution 
eilnootuv : evolution 
eilnosvv : involves 
eilnotu : outline 
eilnotv : violent 
eilnovv : involve 
eilnpp : nipple 
eilnpps : nipples 
eilns : lines 
eilnst : listen silent 
eilnt : intel 
eiloprsuvy : previously 
eilorssuy : seriously 
eilorv : oliver 
eilosu : louise 
eilott : toilet 
eilov : olive 
eilpprssu : suppliers 
eilpprsu : supplier 
eilppssu : supplies 
eilprt : triple 
eilpsx : pixels 
eilpx : pixel 
eilrsv : silver 
eilrv : liver 
eils : lies isle 
eilst : tiles 
eilstt : titles 
eilsv : lives elvis 
eilsw : lewis 
eilt : lite tile 
eiltt : title 
eilv : live evil 
eilwy : wiley 
eimm : mime 
eimmnu : immune 
eimmpru : premium 
eimn : mine 
eimnnoprt : prominent 
eimnnot : mention 
eimnnrssttu : instruments 
eimnnrsttu : instrument 
eimnoost : emotions 
eimnostty : testimony 
eimnptu : pentium 
eimnrtu : runtime 
eimns : mines 
eimnstu : minutes 
eimntu : minute 
eimoprs : promise 
eimoprss : promises 
eimoprv : improve 
eimops : impose 
eimorrrst : terrorism 
eimorsstuy : mysterious 
eimorstu : moisture 
eimosv : movies 
eimov : movie 
eimpr : prime 
eimprst : permits 
eimprt : permit 
eimrssst : mistress 
eimrt : timer merit 
eimrtux : mixture 
eimrx : remix mixer 
eims : semi msie 
eimst : items times 
eimt : time item 
einn : nine 
einnops : pension 
einnopss : pensions 
einnopsssu : suspension 
einnortvy : inventory 
einnoru : reunion 
einnost : tension 
einnr : inner 
einnrsw : winners 
einnrw : winner 
einnst : tennis 
einntt : intent 
einoopprtw : powerpoint 
einoopssss : possession 
einoprrs : prisoner 
einoprrss : prisoners 
einoprst : proteins 
einoprt : protein pointer 
einoqsstu : questions 
einoqstu : question 
einors : senior 
einorss : seniors 
einorsstv : investors 
einorssv : versions 
einorstu : routines 
einorstv : investor 
einorsv : version 
einortu : routine 
einorvz : verizon 
einos : noise 
einosss : session 
einossss : sessions 
einp : pine 
einprrst : printers reprints 
einprrt : printer reprint 
einps : penis spine 
einqruy : enquiry 
einquu : unique 
einrssu : sunrise 
einrst : insert 
einrt : inter 
einrttw : written 
einrtw : winter 
einsstw : witness 
einstu : itunes 
einstv : invest 
einsw : wines 
einttt : titten 
eintty : entity 
einw : wine 
eiooppst : opposite 
eiooprrsty : repository 
eioprrsssuv : supervisors 
eioprrssuv : supervisor 
eioprrsu : superior 
eioprsuv : previous 
eiorrrsstt : terrorists 
eiorrrstt : terrorist 
eiorrrtty : territory 
eiorsst : stories 
eiorssu : serious 
eiostv : soviet 
eip : pie 
eipp : pipe 
eipps : pipes 
eipr : ripe 
eiprrssu : surprise 
eiprsst : stripes 
eiprst : priest 
eiprsz : prizes 
eiprz : prize 
eipss : spies 
eiqsuzz : quizzes 
eiqtu : quite quiet 
eiqtuy : equity 
eirrstw : writers 
eirrsv : rivers 
eirrtw : writer 
eirrv : river 
eirs : rise 
eirssst : sisters 
eirsst : sister resist 
eirssuv : viruses 
eirst : tries tires 
eirstw : writes 
eirsuvv : survive 
eirsw : wires 
eirt : tire tier 
eirtuv : virtue 
eirtw : write 
eirw : wire 
eis : sie 
eisssu : issues 
eisst : sites 
eisstu : suites tissue 
eisstx : exists 
eissu : issue 
eissz : sizes 
eist : site ties 
eistu : suite 
eistx : exist 
eisvw : views wives 
eisw : wise 
eisz : size 
eit : tie 
eitx : exit 
eivw : view 
ej : je 
ejko : joke 
ejkos : jokes 
ejlo : joel 
ejnny : jenny 
ejnoruy : journey 
ejnos : jones 
ejnoy : enjoy 
ejnu : june 
ejo : joe 
ejos : jose 
ejrry : jerry 
ejssu : jesus 
ejst : jets 
ejsw : jews 
ejt : jet 
ekkloo : kelkoo 
eklly : kelly 
eklu : luke 
ekly : kyle 
ekmnoop : pokemon 
ekmnoy : monkey 
ekmos : smoke 
ekn : ken 
eknny : kenny 
ekno : keno 
eknops : spoken 
eknorstw : networks 
eknortw : network 
eknot : token 
eknt : kent 
eknu : nuke 
eknw : knew 
ekopr : poker 
ekops : spoke 
ekorrsw : workers 
ekorrw : worker 
ekorst : stroke 
ekpsy : skype 
ekpt : kept 
ekrry : kerry 
ekrt : trek 
ekrtuy : turkey 
eksy : keys 
eky : key 
el : el le 
ellms : smell 
ellnoy : lonely 
ellopw : powell 
ellorr : roller 
ellosy : solely 
ellovy : lovely 
ellowy : yellow 
ellps : spell 
ellrssu : russell 
ells : sell 
ellss : sells 
ellst : tells 
ellsw : wells 
ellt : tell 
ellw : well 
elm : mel 
elmno : lemon 
elmopry : polymer 
elmopy : employ 
elmost : motels 
elmosuv : volumes 
elmot : motel 
elmouv : volume 
elmrty : myrtle 
eln : len 
elnnos : nelson 
elnntu : tunnel 
elno : leon lone 
elnoss : lesson 
elnosss : lessons 
elnost : stolen 
elnosv : novels 
elnotvy : novelty 
elnov : novel 
elnpty : plenty 
elns : lens 
elnssu : unless 
elnwy : newly 
elo : leo 
eloos : loose 
elop : pole 
elopprry : properly 
elops : slope 
elopsst : topless 
elopz : lopez 
elor : role 
elors : roles 
elorsv : lovers 
elortty : lottery 
elorv : lover 
elorw : lower 
elos : lose sole 
elosss : losses 
elosttu : outlets 
elostw : lowest 
elosv : solve loves 
elottu : outlet 
elov : love 
elppru : purple 
elpr : perl 
elpry : reply 
elpsu : pulse 
elpsuzz : puzzles 
elpuzz : puzzle 
elrsstu : results 
elrstu : result 
elrsu : rules 
elrsuy : surely 
elrttu : turtle 
elrty : tyler 
elru : rule 
elry : rely 
els : les 
elss : less 
elssty : styles 
elst : lets 
elsty : style 
elsux : lexus 
elt : let tel 
elu : leu 
elvy : levy 
em : me em 
emm : mem 
emmmnotu : momentum 
emmnost : moments 
emmnot : moment 
emmo : memo 
emmory : memory 
emmrsu : summer 
emmssuu : museums 
emmsuu : museum 
emn : men 
emnoor : monroe 
emnoorsu : enormous 
emnorsst : monsters 
emnorst : monster 
emnorsuu : numerous 
emnort : mentor 
emnortv : vermont 
emnosw : womens 
emnot : monte 
emnow : women 
emnoy : money 
emns : mens 
emnsu : menus 
emnt : ment 
emnu : menu 
emo : oem 
emooprst : promotes 
emooprt : promote 
emoor : moore 
emop : poem 
emops : poems 
emor : more rome 
emorsv : movers 
emort : metro 
emos : some 
emoss : moses 
emosu : mouse 
emosv : moves 
emov : move 
emprs : sperm 
empt : temp 
empty : empty 
emrry : merry 
emrst : terms 
emrstyy : mystery 
emrsu : serum 
emrsy : myers 
emrt : term 
emss : mess 
emsssty : systems 
emssty : system 
emst : stem 
emt : met 
emuz : muze 
en : en ne 
enno : none neon 
ennooppst : opponents 
ennooppt : opponent 
ennorv : vernon 
ennotw : newton 
ennp : penn 
ennpy : penny 
ennrru : runner 
ennttu : nutten 
eno : one neo 
enoosst : soonest 
enooz : ozone 
enop : open 
enoprs : person 
enoprss : persons 
enoprst : preston 
enoprtw : newport 
enoprv : proven 
enops : epson opens 
enor : reno 
enorss : sensor 
enorsss : sensors 
enorsuv : nervous 
enorsw : owners 
enort : toner notre 
enorw : owner 
enos : ones nose 
enosst : stones 
enost : notes stone tones 
enosz : zones 
enot : note tone 
enov : oven 
enow : owen 
enoz : zone 
enp : pen 
enps : espn pens 
enpst : spent 
enrrstu : returns 
enrrsuy : nursery 
enrrtu : return turner 
enrssu : nurses 
enrsu : nurse 
enrt : rent 
enrtu : tuner 
enrty : entry 
ens : sen 
ensstu : sunset 
enst : sent nest 
enstu : tunes 
enstv : vsnet 
ensw : news 
ent : net ten ent 
entt : tent 
enttwy : twenty 
entu : tune 
entw : went 
entx : next 
enu : une 
enw : new 
eny : yen 
enz : zen 
eo : oe 
eoopprs : propose 
eoopprtty : prototype 
eooprrsst : prostores 
eopp : pope 
eopprr : proper 
eopprrsstu : supporters 
eopprrty : property 
eopprssu : purposes 
eopprsu : purpose 
eoppssu : suppose 
eopr : rope 
eoprrst : reports 
eoprrt : report porter 
eoprsst : posters 
eoprst : poster 
eoprstt : protest 
eoprstx : exports 
eoprsw : powers 
eoprtt : potter 
eoprtty : pottery 
eoprtu : puerto 
eoprtvy : poverty 
eoprtx : export 
eoprty : poetry 
eoprv : prove 
eoprw : power 
eops : pose 
eopssss : possess 
eopssu : spouse 
eopt : poet 
eopx : expo 
eopz : zope 
eoqstu : quotes 
eoqtu : quote 
eorrr : error 
eorrrs : errors 
eorrrt : terror 
eorrsst : resorts 
eorrst : resort roster 
eorrstu : routers 
eorrt : retro 
eorrttu : torture 
eorrtu : router 
eorrv : rover 
eors : rose 
eorss : roses 
eorsst : stores 
eorst : store 
eorstu : routes 
eorstv : voters 
eorstw : towers 
eorsu : euros 
eorsw : worse 
eort : treo 
eortu : route outer 
eortw : wrote tower 
eoru : euro 
eoruvy : voyeur voyuer 
eorv : over 
eorxx : xerox 
eorz : zero 
eos : seo eos 
eostv : votes 
eosx : sexo 
eot : toe 
eotv : vote 
ep : pe ep 
eppr : prep 
eppru : upper 
epr : per pre rep erp 
eprry : perry 
eprss : press 
eprsu : super purse 
eprsuu : pursue 
eprtty : pretty 
epru : pure peru 
eprv : prev 
eps : sep 
epsst : steps 
epst : step pets sept pest 
epstu : setup upset 
epsty : types 
ept : pet 
epty : type 
epx : exp 
eq : eq 
eqruy : query 
eqs : seq 
eqstu : quest 
equ : que 
er : re er 
errsuy : surrey 
errty : terry 
ers : res ser 
erssst : stress 
erssu : users 
erssuv : versus 
erssuvy : surveys 
erst : rest 
ersu : user sure 
ersuvy : survey 
ertu : true 
eru : eur 
erv : rev ver 
ervy : very 
es : se es 
esssux : sussex 
esst : sets 
esstt : tests 
essu : uses suse 
est : set est ste 
estt : test 
esttx : texts 
estw : west 
esu : use sue 
esx : sex 
esxy : sexy 
esy : yes 
et : et te 
ettx : text 
etu : tue 
etw : wet 
etx : ext tex 
ety : yet 
eu : eu 
ev : ve ev 
ew : we 
ex : ex 
ey : ye 
ez : ez 
f : f 
ff : ff 
ffgiinr : griffin 
ffhit : fifth 
ffity : fifty 
ffo : off 
ffstu : stuff 
fg : fg 
fgghiint : fighting 
fghiiinns : finishing 
fghiinnrssu : furnishings 
fghiins : fishing 
fghilst : flights 
fghilt : flight 
fghit : fight 
fghotu : fought 
fgi : fig gif 
fgiilln : filling 
fgiiln : filing 
fgiinst : fisting 
fgiintt : fitting 
fgillnoow : following 
fgilnoor : flooring 
fgilny : flying 
fgimnor : forming 
fginrsu : surfing 
fgist : gifts 
fgit : gift 
fglo : golf 
fglu : gulf 
fgo : fog 
fgoort : forgot 
fgor : frog 
fhiinns : finnish 
fhiins : finish 
fhis : fish 
fhist : shift 
fhlsu : flush 
fhort : forth 
fhortu : fourth 
fi : if fi 
fiij : fiji 
fiiw : wifi 
fijstuu : fujitsu 
fijstuy : justify 
fiju : fuji 
fill : fill 
film : film milf 
films : films milfs 
filoooprt : portfolio 
filorsst : florists 
filorst : florist 
filoss : fossil 
filp : flip 
filt : lift 
fimnor : inform 
fimnoru : uniform 
fimr : firm 
fimrs : firms 
fin : inf fin 
finnooprt : nonprofit 
fino : info 
finosu : fusion 
finoty : notify 
fioprst : profits 
fioprt : profit 
fir : fri 
first : first 
firstu : fruits 
firtu : fruit 
fist : fits fist 
fistw : swift 
fit : fit 
fix : fix 
fklnoor : norfolk 
fklo : folk 
fkloorww : workflow 
fklos : folks 
fknu : funk 
fknuy : funky 
fkor : fork 
fl : fl lf 
flloosw : follows 
flloow : follow 
fllu : full 
flluy : fully 
fln : nfl 
floo : fool 
floor : floor 
floors : floors 
flootz : zoloft 
floppy : floppy 
floru : flour 
flosw : flows 
flou : foul 
flow : flow wolf 
flu : flu 
flux : flux 
fly : fly 
fm : fm mf 
fmor : from form 
fmors : forms 
fmorsu : forums 
fmoru : forum 
fnnuy : funny 
fnort : front 
fnost : fonts 
fnot : font 
fnu : fun 
fo : of fo 
foo : foo 
foopr : proof 
foor : roof 
foost : fotos 
foot : foot foto 
for : for 
forst : frost 
fort : fort 
forty : forty 
foru : four 
fost : soft 
fox : fox 
fp : fp pf 
fpt : ftp 
fr : fr rf 
frsu : surf 
fru : fur 
fs : sf fs 
ft : ft tf 
ftt : tft 
fu : fu 
fuyzz : fuzzy 
fw : fw 
fx : fx 
fy : fy 
g : g 
gg : gg 
gggilno : logging 
gghhhiilst : highlights 
gghhhiilt : highlight 
gghiilnnt : lightning 
gghiilnt : lighting 
ggi : gig 
ggiinns : singing signing 
ggiinv : giving 
gginnoo : ongoing 
ggino : going 
gginorw : growing 
ghhi : high 
ghhily : highly 
ghhis : highs 
ghhloortuy : thoroughly 
ghhoorttuu : throughout 
ghhoortu : thorough 
ghhortu : through 
ghhosttu : thoughts 
ghhottu : thought 
ghhotu : though 
ghhu : hugh 
ghiikn : hiking 
ghiiknnt : thinking 
ghiinpps : shipping 
ghiinr : hiring 
ghiinsst : insights 
ghiinst : insight 
ghiinsw : wishing 
ghiintt : hitting 
ghiknst : knights 
ghiknt : knight 
ghillsty : slightly 
ghiloopsyy : physiology 
ghilopstt : spotlight 
ghilst : lights slight 
ghilt : light 
ghimt : might 
ghimty : mighty 
ghinnnottu : huntington 
ghinnot : nothing 
ghinntu : hunting 
ghinoost : shooting 
ghinop : hoping 
ghinopps : shopping 
ghinortw : throwing 
ghinost : hosting 
ghinosu : housing 
ghinosw : showing 
ghinott : tonight 
ghinpsu : pushing 
ghins : singh 
ghinst : things nights 
ghint : night thing 
ghirst : rights 
ghirt : right 
ghirtw : wright 
ghist : sight 
ghitt : tight 
ghloruy : roughly 
ghno : hong 
ghnost : thongs 
ghnot : thong 
ghnruy : hungry 
ghnu : hung 
ghortw : growth 
ghoru : rough 
ghost : ghost 
ghostu : sought 
ghotu : tough ought 
ghou : hugo 
ghz : ghz 
gi : gi 
giiilmnt : limiting 
giiinnoopst : positioning 
giiinstv : visiting 
giijnno : joining 
giiklln : killing 
giiklnn : linking 
giiknntt : knitting 
giiknrst : striking 
giikns : skiing 
giiknss : kissing 
giiknv : viking 
giillnw : willing 
giilnnovv : involving 
giilnsst : listings 
giilnst : listing 
giilnv : living 
giimmnsw : swimming 
giimnn : mining 
giimnnoort : monitoring 
giimnoprs : promising 
giimnoprv : improving 
giimnss : missing 
giimnt : timing 
giimnx : mixing 
giinnnw : winning 
giinnopt : pointing 
giinnprt : printing 
giinor : origin 
giinors : origins 
giinprrssu : surprising 
giinpss : pissing 
giinqrstu : squirting 
giinrs : rising 
giinrstw : writings 
giinrtw : writing 
giinrv : virgin 
giinrw : wiring 
giinstt : sitting 
gijmnpu : jumping 
giklnoo : looking 
gikmnos : smoking 
gikn : king 
giknnost : kingston 
giknnow : knowing 
giknorw : working 
gikns : kings 
gillnor : rolling 
gillnpu : pulling 
gillr : grill 
gilmmnoouy : immunology 
gilno : login 
gilnos : losing 
gilnosv : solving 
gilnov : loving 
gilnpsu : plugins 
gilnpu : plugin 
gilnru : ruling 
gilny : lying 
gilr : girl 
gilrs : girls 
giltuy : guilty 
gim : img 
gimnnor : morning 
gimnnotu : mounting 
gimnooprt : promoting 
gimnov : moving 
gimnowy : wyoming 
gin : ing 
ginnnru : running 
ginnnstu : stunning 
ginnoz : zoning 
ginnrsu : nursing 
ginnrtu : turning 
ginntu : tuning 
ginopprstu : supporting 
ginoppst : stopping 
ginoprst : sporting 
ginops : posing 
ginopsst : postings 
ginopst : posting 
ginortu : routing touring 
ginotv : voting 
ginp : ping 
ginprs : spring 
ginprss : springs 
ginpsu : signup 
ginpttu : putting 
ginpty : typing 
ginr : ring 
ginrs : rings 
ginrsst : strings 
ginrst : string 
ginrty : trying 
gins : sign sing 
ginss : signs 
ginsu : using 
ginsw : wings swing 
ginw : wing 
giopss : gossip 
gip : pig 
gipr : grip 
gipz : gzip 
gis : gis sig 
giu : gui 
gjp : jpg 
gk : kg 
gkno : kong 
gkt : gtk 
gl : lg gl 
glno : long 
glnorsty : strongly 
glnu : lung 
glo : log 
gloo : logo 
gloos : logos 
glory : glory 
glos : logs 
glow : glow 
glp : gpl 
glpu : plug 
gluy : ugly 
gm : mg gm 
gmp : mpg 
gmrsst : msgstr 
gms : msg gsm 
gmt : gmt 
gmu : mug 
gmy : gym 
gn : ng 
gnorst : strong 
gnorw : wrong grown 
gnos : song 
gnoss : songs 
gnouy : young 
gnsu : guns 
gnu : gnu gun 
go : go og 
goot : goto 
goprsu : groups 
gopru : group 
gor : org 
gorss : gross 
gorsw : grows 
gorw : grow 
gory : orgy 
got : got 
gp : pg gp 
gpp : pgp 
gpr : rpg 
gps : gps 
gpt : tgp 
gr : gr rg 
grsu : rugs 
gru : rug 
gruu : guru 
gs : gs sg 
gssu : usgs 
gst : gst 
gsuy : guys 
gt : gt 
guy : guy 
gv : vg 
h : h 
hh : hh 
hhilooppsy : philosophy 
hhmrty : rhythm 
hhoooppst : photoshop 
hi : hi 
hiillpps : phillips 
hiilpp : philip 
hiilpps : philips 
hiilsstw : wishlist 
hiintw : within 
hiirs : irish 
hiknops : hopkins 
hiknst : thinks 
hiknt : think 
hikrstu : turkish 
hill : hill 
hills : hills 
hilnot : hilton 
hilops : polish 
hilp : phil 
hilssty : stylish 
hilstw : whilst 
him : him 
himotty : timothy 
himprtu : triumph 
himst : smith 
hinoopprsss : sponsorship 
hinoorz : horizon 
hinopstw : township 
hinst : hints 
hint : thin hint 
hioo : ohio 
hioprsw : worship 
hiorsty : history 
hiottuw : without 
hip : hip phi 
hips : ship 
hipss : ships 
hirsst : shirts 
hirst : shirt 
hirtty : thirty 
his : his 
hist : this hits hist shit 
histx : sixth 
hisw : wish 
hit : hit 
hitw : with 
hiv : hiv 
hjnnoos : johnson 
hjnnoost : johnston 
hjnnoy : johnny 
hjno : john 
hjnos : johns 
hjos : josh 
hk : hk 
hkoo : hook 
hkooprssw : workshops 
hkooprsw : workshop 
hl : hl 
hllnoouu : honolulu 
hlloow : hollow 
hlloy : holly 
hllu : hull 
hlmnoty : monthly 
hlmoptuy : plymouth 
hlmt : html 
hlmtx : xhtml 
hln : nhl 
hlorsty : shortly 
hloruy : hourly 
hloy : holy 
hm : mh 
hmnoopst : thompson 
hmnoost : thomson 
hmnopsyy : symphony 
hmnost : months 
hmnot : month 
hmooprsttu : portsmouth 
hmoost : smooth 
hmoru : humor 
hmotu : mouth 
hmow : whom 
hmp : mph 
hmpruy : murphy 
hmty : myth 
hmz : mhz 
hn : nh 
hno : hon 
hnoor : honor 
hnoors : honors 
hnoostu : houston 
hnopty : python 
hnor : horn 
hnort : north 
hnortw : thrown 
hnory : horny 
hnosw : shown 
hns : nhs 
hntu : hunt 
ho : oh ho 
hoopst : photos 
hoopt : photo 
hoorrr : horror 
hoost : shoot 
hoott : tooth 
hootw : howto 
hop : hop 
hops : shop 
hopss : shops 
hopssz : zshops 
horsst : shorts 
horst : short 
horstw : throws 
horsu : hours 
hortw : worth throw 
hortwy : worthy 
horu : hour 
hosst : shots hosts 
hossw : shows 
host : host shot 
hostu : south 
hosw : show 
hot : hot 
hotu : thou 
hotuy : youth 
how : who how 
hp : hp ph 
hpp : php 
hpsu : push 
hpsy : phys 
hptt : http 
hq : hq 
hr : hr rh 
hrs : hrs 
hrsu : rush 
hrttu : truth 
hrtu : hurt thru ruth 
hs : sh hs 
hstu : thus shut 
hsv : vhs 
ht : th ht 
htu : thu 
hty : thy 
hu : uh hu 
hwy : why hwy 
hz : hz 
i : i 
ii : ii 
iii : iii 
iiiimppssss : mississippi 
iiijjk : kijiji 
iiillnos : illinois 
iiinnosstttu : institutions 
iiinnostttu : institution 
iiinnosv : invision 
iiiv : viii 
iiktw : twiki 
iikw : wiki 
iillmno : million 
iillmnos : millions 
iilmst : limits 
iilmt : limit 
iilnnsu : insulin 
iilnov : violin 
iilttuy : utility 
iimmmnu : minimum 
iimn : mini 
iimnoosss : omissions 
iimnorty : minority 
iimnoss : mission 
iimnosss : missions 
iimnrsty : ministry 
iimorssu : missouri 
iinnoop : opinion 
iinnoops : opinions 
iinnorttu : nutrition 
iinooopprst : proposition 
iinoooppst : opposition 
iinooprssv : provisions 
iinooprsv : provision 
iinoopsst : positions 
iinoopst : position 
iinosv : vision 
iinottu : tuition 
iinqruy : inquiry 
iinrtty : trinity 
iioprrty : priority 
iiorsstv : visitors 
iiorstv : visitor 
iiprsst : spirits 
iiprst : spirit 
iisstv : visits 
iistv : visit 
iiv : vii 
ijll : jill 
ijm : jim 
ijmmy : jimmy 
ijno : join 
ijnoru : junior 
ijnos : joins 
ijnot : joint 
ijnruy : injury 
ijnstu : justin 
ikkr : kirk 
ikll : kill 
iklls : skill kills 
ikllss : skills 
iklm : milk 
ikln : link 
iklns : links 
ikloott : toolkit 
ikls : silk 
ikm : kim 
ikn : ink 
iknno : nikon 
iknp : pink 
ikns : skin sink 
iknss : skins 
iknstw : twinks 
iknt : knit 
ikprsstu : upskirts 
ikprstu : upskirt 
ikps : skip 
ikrs : risk 
ikrss : risks 
ikrsst : skirts 
ikrst : skirt 
iks : ski 
ikss : kiss 
ikst : kits 
iksuuz : suzuki 
ikt : kit 
iktty : kitty 
il : il li 
ill : ill lil 
illm : mill 
illms : mills 
illnooptu : pollution 
illopw : pillow 
illoww : willow 
illp : pill 
illps : pills 
illst : still 
illsy : silly 
illt : till 
illw : will 
ilm : mil 
ilmmssu : muslims 
ilmmsu : muslim 
ilmnot : milton 
ilmpsy : simply 
ilms : slim 
ilmtu : multi 
iln : nil 
ilno : lion 
ilnoosstu : solutions 
ilnoostu : solution 
ilnos : lions 
ilnosw : wilson 
ilnt : intl 
ilntu : until 
ilnux : linux 
ilnvy : vinyl 
ilo : oil 
ilopt : pilot 
ilos : soil oils 
ilosu : louis 
ilp : lip 
ilppsu : pupils 
ilps : slip lips 
ilpst : split 
ilqtu : quilt 
ilsst : lists 
ilst : list 
ilstu : utils 
ilsu : luis 
ilt : lit til 
ilz : liz 
im : mi im 
immnosy : mysimon 
immopssuy : symposium 
immoptu : optimum 
immstu : summit 
imn : min 
imnoooprst : promotions 
imnoooprt : promotion 
imnoorrs : morrison 
imnoorst : monitors 
imnoort : monitor 
imnoot : motion 
imnopss : simpson 
imnopsss : simpsons 
imnor : minor 
imnos : simon 
imns : mins 
imnsu : minus 
imnt : mint 
imoprst : imports 
imoprt : import 
imorrr : mirror 
imorrrs : mirrors 
imorrs : morris 
imorstu : tourism 
imr : rim 
imrt : trim 
ims : sim 
imss : miss sims 
imsw : swim 
imt : tim mit 
imx : mix 
in : in ni 
inn : inn 
innoo : onion 
innoot : notion 
innostw : winston 
innosu : unions 
innou : union 
inns : inns 
ino : ion 
inooopprrt : proportion 
inoopprttuy : opportunity 
inooprst : portions 
inooprt : portion 
inoops : poison 
inoopst : options 
inoopt : option 
inoprs : prison 
inopsssy : synopsis 
inopst : points 
inopt : point 
inor : iron 
inort : intro 
inost : tions 
inot : into tion 
inp : pin 
inprst : prints sprint 
inprt : print 
inps : spin pins 
inpstu : inputs 
inptu : input 
ins : sin ins 
inss : issn 
instu : units 
instw : twins 
insw : wins 
int : int tin 
intu : unit 
intuy : unity 
intw : twin 
inty : tiny 
inu : uni 
inuv : univ 
inux : unix 
inw : win 
io : io 
ioprr : prior 
iopv : voip 
ior : rio 
iorrssuvv : survivors 
iorrsuvv : survivor 
iorsttu : tourist 
iort : trio 
iorvy : ivory 
ios : iso 
ip : ip pi 
ipr : rip 
iprsst : strips 
iprst : strip trips 
iprstuu : pursuit 
iprt : trip 
iprx : prix 
ips : isp psi sip ips 
ipss : piss 
ipst : tips 
ipt : tip pit 
ipv : vip 
ipx : pix 
ipz : zip 
iqrstu : squirt 
iqtu : quit 
iqu : qui 
iquz : quiz 
ir : ri ir 
irs : sir sri irs 
irstw : wrist 
irsuv : virus 
irt : tri 
iru : uri 
is : is si 
isssw : swiss 
isstu : suits 
ist : its sit ist 
istt : tits 
isttw : twist 
istu : suit 
isx : six 
it : it ti 
itt : tit 
itw : wit 
iu : ui 
iv : iv vi 
iw : wi 
ix : xi ix 
j : j 
jj : jj 
jknu : junk 
jlu : jul 
jluy : july 
jm : jm mj 
jmpu : jump 
jn : nj 
jno : jon 
jnu : jun 
jo : jo 
joy : joy 
jp : jp pj 
jr : jr rj 
jruy : jury 
js : js 
jstu : just 
k : k 
kloo : look 
kloootu : outlook 
kloopu : lookup 
kloos : looks 
km : km 
knnnouw : unknown 
knnow : known 
knosw : knows 
knouy : yukon 
know : know 
knpu : punk 
knrtu : trunk 
ko : ok ko 
koortuw : workout 
koot : took 
kooty : tokyo 
kopr : pork 
korsw : works 
korw : work 
kory : york 
kp : pk 
krtu : kurt 
ks : ks sk 
ksu : sku 
ksy : sky 
ku : uk 
kw : kw 
ky : ky 
l : l 
ll : ll 
llnu : null 
llo : lol 
llop : poll 
llops : polls 
llor : roll 
llors : rolls 
lloswy : slowly 
llot : toll 
llp : llp 
llpu : pull 
lm : ml lm 
lmnooos : solomon 
lmopprty : promptly 
lmopsuy : olympus 
lmosty : mostly 
lmqsy : mysql 
lms : mls 
lmx : xml 
ln : nl ln 
lnnoy : nylon 
lnny : lynn 
lnoy : only 
lo : lo ol 
loop : pool loop polo 
loops : pools loops 
loos : solo 
loost : tools 
loot : tool 
loovv : volvo 
loow : wool 
loprtuy : poultry 
lopst : plots 
lopt : plot 
lopy : poly 
los : los sol 
loss : loss 
losst : slots 
lossu : souls 
lost : lost lots slot 
lostu : lotus 
losu : soul 
losw : slow lows 
lot : lot 
lotv : volt 
lou : lou 
lov : vol 
low : low 
lp : lp pl 
lppsuy : supply 
lprssuu : surplus 
lpsu : plus 
lqs : sql 
lr : rl 
lrsu : urls 
lrtuy : truly 
lru : url 
lruuxy : luxury 
ls : sl ls 
lss : ssl 
lsstu : sluts 
lsstuy : stylus 
lstu : slut 
lt : lt 
lu : ul lu 
lx : xl 
m : m 
mm : mm 
mmo : mom 
mmopssty : symptoms 
mmos : moms 
mmoty : tommy 
mn : nm mn 
mno : mon 
mnoo : moon mono 
mnor : norm 
mnostu : mounts 
mnotu : mount 
mns : msn 
mo : mo om 
mooorrtw : tomorrow 
moopr : promo 
moor : room 
moors : rooms 
moorst : motors 
moort : motor 
mooz : zoom 
mopprt : prompt 
mor : rom 
morst : storm 
mortu : tumor 
morw : worm 
moss : moss 
most : most 
mot : tom 
mp : pm mp 
mpp : ppm 
mppsu : pumps 
mppu : pump 
mpr : rpm 
mpst : smtp 
mpt : tmp 
mr : mr rm 
mrs : mrs 
ms : ms sm 
mss : sms 
mstu : must 
msu : sum 
mt : mt tm 
mtv : mtv 
mu : um mu 
muz : zum 
mv : mv 
mw : mw wm 
mx : mx 
my : my 
n : n 
nn : nn 
nno : non 
nnoo : noon 
nnoort : norton 
nnsuy : sunny 
no : on no 
nooortt : toronto 
noopr : porno 
nooprss : sponsor 
nooprsss : sponsors 
noos : soon 
noot : onto 
nopr : porn 
nopu : upon 
nor : nor ron 
norw : worn 
nos : son ons 
noss : sons 
nost : tons 
nostw : towns 
nosw : snow owns 
nosy : sony 
not : not ton 
notu : unto 
notw : town 
noty : tony 
nov : nov von 
now : now own won 
np : np pn 
npv : vpn 
nr : nr rn 
nrstu : turns 
nrsu : runs 
nrtu : turn 
nru : run 
ns : ns sn 
nstu : nuts 
nsu : sun 
nsw : nsw 
nt : nt tn 
ntu : nut 
nu : un nu 
nv : nv 
nw : nw wn 
nxxx : xnxx 
ny : ny yn 
nz : nz 
o : o 
oo : oo 
ooo : ooo 
oopr : poor 
ooprst : troops 
oops : oops 
oorst : roots 
oort : root 
oot : too 
ooz : zoo 
op : po op 
opp : pop 
opprsstu : supports 
opprstu : support 
opr : pro por 
oprs : pros 
oprsst : sports 
oprst : sport ports 
oprt : port prot 
opru : pour 
oprxy : proxy 
ops : pos 
opsst : posts spots stops 
opst : post stop spot tops 
opsttuu : outputs 
opsu : soup 
opt : top pot opt 
opttuu : output 
or : or ro 
orrsy : sorry 
orrwy : worry 
orss : ross 
orsst : sorts 
orst : sort 
orstu : tours 
orstw : worst 
orsty : story 
orsu : ours 
orsuy : yours 
orsw : rows 
orttu : trout 
ortu : tour 
orty : troy 
oru : our 
oruy : your 
orw : row 
ory : roy 
os : so os 
osty : toys 
osx : sox 
ot : to ot 
otu : out 
otw : two wto 
oty : toy 
ou : ou 
ouy : you 
oww : wow 
oy : yo 
oz : oz 
p : p 
pp : pp 
pppuy : puppy 
pps : psp 
pr : pr rp 
prr : rrp 
ps : sp ps 
pssu : usps 
pssuy : pussy 
pst : pst pts 
pstu : puts 
psu : ups 
psy : spy 
pt : pt tp 
ptu : put 
pty : pty 
pu : up 
pv : vp 
pw : wp 
px : xp 
q : q 
qs : sq 
qt : qt 
qty : qty 
r : r 
rr : rr 
rs : rs sr 
rss : rss 
rssttu : trusts 
rst : str 
rsttu : trust 
rsu : usr sur 
rsy : yrs 
rt : tr rt 
rty : try 
ru : ur ru 
ruw : urw 
rv : rv 
rw : rw wr 
rx : rx 
ry : yr 
s : s 
ss : ss 
ssy : sys 
st : st ts 
stv : tvs 
su : us su 
suz : zus 
sv : vs sv 
sw : sw ws 
t : t 
tt : tt 
tu : ut tu 
tv : tv vt 
tw : wt 
tx : tx 
ty : ty 
u : u 
uv : uv 
uw : uw wu 
uy : yu 
uz : zu 
v : v 
vw : wv 
w : w 
ww : ww 
www : www 
wx : wx 
wy : wy 
x : x 
xx : xx 
xxx : xxx 
y : y 
z : z 
